"filename", "language", "C++", "C#", "comment", "blank", "total"
"c:\Users\wadan\Desktop\SGA\Portfolio\Unreal\Project\UE_PUBG\Source\UE_PUBG\Airplane\C_Airplane.cpp", "C++", 1, 0, 0, 0, 1
"c:\Users\wadan\Desktop\SGA\Portfolio\Unreal\Project\UE_PUBG\Source\UE_PUBG\Airplane\C_AirplaneManager.cpp", "C++", 4, 0, 3, 0, 7
"c:\Users\wadan\Desktop\SGA\Portfolio\Unreal\Project\UE_PUBG\Source\UE_PUBG\Airplane\C_AirplaneManager.h", "C++", 1, 0, 1, 2, 4
"c:\Users\wadan\Desktop\SGA\Portfolio\Unreal\Project\UE_PUBG\Source\UE_PUBG\C_MyMotionWarpingComponent.cpp", "C++", 1, 0, 1, 4, 6
"c:\Users\wadan\Desktop\SGA\Portfolio\Unreal\Project\UE_PUBG\Source\UE_PUBG\C_MyMotionWarpingComponent.h", "C++", 9, 0, 4, 6, 19
"c:\Users\wadan\Desktop\SGA\Portfolio\Unreal\Project\UE_PUBG\Source\UE_PUBG\Character\C_AnimBasicCharacter.cpp", "C++", 5, 0, 3, 0, 8
"c:\Users\wadan\Desktop\SGA\Portfolio\Unreal\Project\UE_PUBG\Source\UE_PUBG\Character\C_AnimBasicCharacter.h", "C++", 5, 0, 0, 0, 5
"c:\Users\wadan\Desktop\SGA\Portfolio\Unreal\Project\UE_PUBG\Source\UE_PUBG\Character\C_BasicCharacter.cpp", "C++", -9, 0, 47, 14, 52
"c:\Users\wadan\Desktop\SGA\Portfolio\Unreal\Project\UE_PUBG\Source\UE_PUBG\Character\C_BasicCharacter.h", "C++", 8, 0, 2, -2, 8
"c:\Users\wadan\Desktop\SGA\Portfolio\Unreal\Project\UE_PUBG\Source\UE_PUBG\Character\C_Player.cpp", "C++", 59, 0, 17, 21, 97
"c:\Users\wadan\Desktop\SGA\Portfolio\Unreal\Project\UE_PUBG\Source\UE_PUBG\Character\C_Player.h", "C++", 8, 0, 3, 0, 11
"c:\Users\wadan\Desktop\SGA\Portfolio\Unreal\Project\UE_PUBG\Source\UE_PUBG\Character\Component\C_AttachableItemMeshComponent.cpp", "C++", 9, 0, 3, 3, 15
"c:\Users\wadan\Desktop\SGA\Portfolio\Unreal\Project\UE_PUBG\Source\UE_PUBG\Character\Component\C_EquippedComponent.cpp", "C++", 27, 0, 26, 11, 64
"c:\Users\wadan\Desktop\SGA\Portfolio\Unreal\Project\UE_PUBG\Source\UE_PUBG\Character\Component\C_EquippedComponent.h", "C++", 5, 0, 9, 2, 16
"c:\Users\wadan\Desktop\SGA\Portfolio\Unreal\Project\UE_PUBG\Source\UE_PUBG\Character\Component\C_InputComponent.cpp", "C++", 35, 0, 10, 8, 53
"c:\Users\wadan\Desktop\SGA\Portfolio\Unreal\Project\UE_PUBG\Source\UE_PUBG\Character\Component\C_InvenComponent.cpp", "C++", 58, 0, -7, 13, 64
"c:\Users\wadan\Desktop\SGA\Portfolio\Unreal\Project\UE_PUBG\Source\UE_PUBG\Character\Component\C_InvenComponent.h", "C++", 8, 0, 5, 4, 17
"c:\Users\wadan\Desktop\SGA\Portfolio\Unreal\Project\UE_PUBG\Source\UE_PUBG\Character\Component\C_InvenSystem.cpp", "C++", 0, 0, -26, 4, -22
"c:\Users\wadan\Desktop\SGA\Portfolio\Unreal\Project\UE_PUBG\Source\UE_PUBG\Character\Component\C_InvenSystem.h", "C++", -1, 0, 11, 1, 11
"c:\Users\wadan\Desktop\SGA\Portfolio\Unreal\Project\UE_PUBG\Source\UE_PUBG\Character\Component\C_ParkourComponent.cpp", "C++", 353, 0, 66, 117, 536
"c:\Users\wadan\Desktop\SGA\Portfolio\Unreal\Project\UE_PUBG\Source\UE_PUBG\Character\Component\C_ParkourComponent.h", "C++", 88, 0, 45, 54, 187
"c:\Users\wadan\Desktop\SGA\Portfolio\Unreal\Project\UE_PUBG\Source\UE_PUBG\Character\Component\C_PlayerController.cpp", "C++", 14, 0, 1, 4, 19
"c:\Users\wadan\Desktop\SGA\Portfolio\Unreal\Project\UE_PUBG\Source\UE_PUBG\Character\Component\C_PlayerController.h", "C++", 11, 0, 4, 5, 20
"c:\Users\wadan\Desktop\SGA\Portfolio\Unreal\Project\UE_PUBG\Source\UE_PUBG\Character\Component\C_SkyDivingComponent.cpp", "C++", 3, 0, 4, 3, 10
"c:\Users\wadan\Desktop\SGA\Portfolio\Unreal\Project\UE_PUBG\Source\UE_PUBG\Character\Component\ParkourActionStrategy\C_MantleHighActionStrategy.cpp", "C++", 41, 0, 5, 27, 73
"c:\Users\wadan\Desktop\SGA\Portfolio\Unreal\Project\UE_PUBG\Source\UE_PUBG\Character\Component\ParkourActionStrategy\C_MantleHighActionStrategy.h", "C++", 12, 0, 4, 7, 23
"c:\Users\wadan\Desktop\SGA\Portfolio\Unreal\Project\UE_PUBG\Source\UE_PUBG\Character\Component\ParkourActionStrategy\C_MantleLowActionStrategy.cpp", "C++", 26, 0, 3, 18, 47
"c:\Users\wadan\Desktop\SGA\Portfolio\Unreal\Project\UE_PUBG\Source\UE_PUBG\Character\Component\ParkourActionStrategy\C_MantleLowActionStrategy.h", "C++", 12, 0, 4, 7, 23
"c:\Users\wadan\Desktop\SGA\Portfolio\Unreal\Project\UE_PUBG\Source\UE_PUBG\Character\Component\ParkourActionStrategy\C_VaultHighActionStrategy.cpp", "C++", 43, 0, 6, 28, 77
"c:\Users\wadan\Desktop\SGA\Portfolio\Unreal\Project\UE_PUBG\Source\UE_PUBG\Character\Component\ParkourActionStrategy\C_VaultHighActionStrategy.h", "C++", 12, 0, 4, 6, 22
"c:\Users\wadan\Desktop\SGA\Portfolio\Unreal\Project\UE_PUBG\Source\UE_PUBG\Character\Component\ParkourActionStrategy\C_VaultLowActionStrategy.cpp", "C++", 45, 0, 7, 26, 78
"c:\Users\wadan\Desktop\SGA\Portfolio\Unreal\Project\UE_PUBG\Source\UE_PUBG\Character\Component\ParkourActionStrategy\C_VaultLowActionStrategy.h", "C++", 12, 0, 4, 7, 23
"c:\Users\wadan\Desktop\SGA\Portfolio\Unreal\Project\UE_PUBG\Source\UE_PUBG\Character\Component\ParkourActionStrategy\I_ParkourActionStrategy.cpp", "C++", 1, 0, 2, 4, 7
"c:\Users\wadan\Desktop\SGA\Portfolio\Unreal\Project\UE_PUBG\Source\UE_PUBG\Character\Component\ParkourActionStrategy\I_ParkourActionStrategy.h", "C++", 15, 0, 10, 9, 34
"c:\Users\wadan\Desktop\SGA\Portfolio\Unreal\Project\UE_PUBG\Source\UE_PUBG\HUD\C_HUDWidget.h", "C++", 4, 0, 0, 3, 7
"c:\Users\wadan\Desktop\SGA\Portfolio\Unreal\Project\UE_PUBG\Source\UE_PUBG\HUD\C_MainMapWidget.cpp", "C++", -75, 0, -1, -30, -106
"c:\Users\wadan\Desktop\SGA\Portfolio\Unreal\Project\UE_PUBG\Source\UE_PUBG\HUD\C_MainMapWidget.h", "C++", -17, 0, 6, -7, -18
"c:\Users\wadan\Desktop\SGA\Portfolio\Unreal\Project\UE_PUBG\Source\UE_PUBG\HUD\C_MapWidget.cpp", "C++", 80, 0, 17, 28, 125
"c:\Users\wadan\Desktop\SGA\Portfolio\Unreal\Project\UE_PUBG\Source\UE_PUBG\HUD\C_MapWidget.h", "C++", 20, 0, 23, 20, 63
"c:\Users\wadan\Desktop\SGA\Portfolio\Unreal\Project\UE_PUBG\Source\UE_PUBG\InvenUserInterface\C_BasicSlotWidget.cpp", "C++", 57, 0, 14, 30, 101
"c:\Users\wadan\Desktop\SGA\Portfolio\Unreal\Project\UE_PUBG\Source\UE_PUBG\InvenUserInterface\C_BasicSlotWidget.h", "C++", 23, 0, 5, 12, 40
"c:\Users\wadan\Desktop\SGA\Portfolio\Unreal\Project\UE_PUBG\Source\UE_PUBG\InvenUserInterface\C_DragDropOperation.h", "C++", 7, 0, 0, 2, 9
"c:\Users\wadan\Desktop\SGA\Portfolio\Unreal\Project\UE_PUBG\Source\UE_PUBG\InvenUserInterface\C_EquipSlot.cpp", "C++", 67, 0, 11, 9, 87
"c:\Users\wadan\Desktop\SGA\Portfolio\Unreal\Project\UE_PUBG\Source\UE_PUBG\InvenUserInterface\C_EquipSlot.h", "C++", 6, 0, 12, 8, 26
"c:\Users\wadan\Desktop\SGA\Portfolio\Unreal\Project\UE_PUBG\Source\UE_PUBG\InvenUserInterface\C_EquipmentPanel.cpp", "C++", 40, 0, 1, 10, 51
"c:\Users\wadan\Desktop\SGA\Portfolio\Unreal\Project\UE_PUBG\Source\UE_PUBG\InvenUserInterface\C_EquipmentPanel.h", "C++", 37, 0, 4, 18, 59
"c:\Users\wadan\Desktop\SGA\Portfolio\Unreal\Project\UE_PUBG\Source\UE_PUBG\InvenUserInterface\C_InvenUiWidget.cpp", "C++", 17, 0, 1, 8, 26
"c:\Users\wadan\Desktop\SGA\Portfolio\Unreal\Project\UE_PUBG\Source\UE_PUBG\InvenUserInterface\C_InvenUiWidget.h", "C++", 6, 0, 0, 4, 10
"c:\Users\wadan\Desktop\SGA\Portfolio\Unreal\Project\UE_PUBG\Source\UE_PUBG\InvenUserInterface\C_ItemBarWidget.cpp", "C++", -2, 0, 19, 7, 24
"c:\Users\wadan\Desktop\SGA\Portfolio\Unreal\Project\UE_PUBG\Source\UE_PUBG\InvenUserInterface\C_ItemBarWidget.h", "C++", 6, 0, 5, 2, 13
"c:\Users\wadan\Desktop\SGA\Portfolio\Unreal\Project\UE_PUBG\Source\UE_PUBG\InvenUserInterface\C_MainGunWidget.cpp", "C++", 59, 0, 15, 26, 100
"c:\Users\wadan\Desktop\SGA\Portfolio\Unreal\Project\UE_PUBG\Source\UE_PUBG\InvenUserInterface\C_MainGunWidget.h", "C++", -3, 0, 6, 3, 6
"c:\Users\wadan\Desktop\SGA\Portfolio\Unreal\Project\UE_PUBG\Source\UE_PUBG\InvenUserInterface\C_MyItemListWidget.cpp", "C++", 17, 0, 0, 3, 20
"c:\Users\wadan\Desktop\SGA\Portfolio\Unreal\Project\UE_PUBG\Source\UE_PUBG\InvenUserInterface\C_MyItemListWidget.h", "C++", -1, 0, 8, 0, 7
"c:\Users\wadan\Desktop\SGA\Portfolio\Unreal\Project\UE_PUBG\Source\UE_PUBG\InvenUserInterface\C_ThrowableWidget.cpp", "C++", 11, 0, 0, 0, 11
"c:\Users\wadan\Desktop\SGA\Portfolio\Unreal\Project\UE_PUBG\Source\UE_PUBG\InvenUserInterface\C_ThrowableWidget.h", "C++", -5, 0, 6, 0, 1
"c:\Users\wadan\Desktop\SGA\Portfolio\Unreal\Project\UE_PUBG\Source\UE_PUBG\Item\AttachmentActors\AttachmentActor.h", "C++", 1, 0, 0, -1, 0
"c:\Users\wadan\Desktop\SGA\Portfolio\Unreal\Project\UE_PUBG\Source\UE_PUBG\Item\AttachmentActors\C_Attachment_Compensator.cpp", "C++", 46, 0, 1, 10, 57
"c:\Users\wadan\Desktop\SGA\Portfolio\Unreal\Project\UE_PUBG\Source\UE_PUBG\Item\AttachmentActors\C_Attachment_Compensator.h", "C++", 18, 0, 7, 7, 32
"c:\Users\wadan\Desktop\SGA\Portfolio\Unreal\Project\UE_PUBG\Source\UE_PUBG\Item\AttachmentActors\C_Attachment_VertGrip.cpp", "C++", 47, 0, 1, 12, 60
"c:\Users\wadan\Desktop\SGA\Portfolio\Unreal\Project\UE_PUBG\Source\UE_PUBG\Item\AttachmentActors\C_Attachment_VertGrip.h", "C++", 18, 0, 7, 7, 32
"c:\Users\wadan\Desktop\SGA\Portfolio\Unreal\Project\UE_PUBG\Source\UE_PUBG\Item\C_Item.cpp", "C++", 7, 0, 5, 0, 12
"c:\Users\wadan\Desktop\SGA\Portfolio\Unreal\Project\UE_PUBG\Source\UE_PUBG\Item\C_Item.h", "C++", 6, 0, 21, 8, 35
"c:\Users\wadan\Desktop\SGA\Portfolio\Unreal\Project\UE_PUBG\Source\UE_PUBG\Item\ConsumableItem\Boosting\C_EnergyDrink.h", "C++", 0, 0, 1, 1, 2
"c:\Users\wadan\Desktop\SGA\Portfolio\Unreal\Project\UE_PUBG\Source\UE_PUBG\Item\ConsumableItem\Boosting\C_PainKiller.cpp", "C++", 0, 0, 0, 1, 1
"c:\Users\wadan\Desktop\SGA\Portfolio\Unreal\Project\UE_PUBG\Source\UE_PUBG\Item\ConsumableItem\Boosting\C_PainKiller.h", "C++", 0, 0, 1, 1, 2
"c:\Users\wadan\Desktop\SGA\Portfolio\Unreal\Project\UE_PUBG\Source\UE_PUBG\Item\ConsumableItem\C_BoostItem.cpp", "C++", 7, 0, 0, 2, 9
"c:\Users\wadan\Desktop\SGA\Portfolio\Unreal\Project\UE_PUBG\Source\UE_PUBG\Item\ConsumableItem\C_BoostItem.h", "C++", 1, 0, 0, 1, 2
"c:\Users\wadan\Desktop\SGA\Portfolio\Unreal\Project\UE_PUBG\Source\UE_PUBG\Item\ConsumableItem\C_ConsumableItem.cpp", "C++", 82, 0, 21, 27, 130
"c:\Users\wadan\Desktop\SGA\Portfolio\Unreal\Project\UE_PUBG\Source\UE_PUBG\Item\ConsumableItem\C_ConsumableItem.h", "C++", 10, 0, 1, 11, 22
"c:\Users\wadan\Desktop\SGA\Portfolio\Unreal\Project\UE_PUBG\Source\UE_PUBG\Item\ConsumableItem\Healing\C_Bandage.cpp", "C++", 10, 0, 0, 1, 11
"c:\Users\wadan\Desktop\SGA\Portfolio\Unreal\Project\UE_PUBG\Source\UE_PUBG\Item\ConsumableItem\Healing\C_Bandage.h", "C++", 3, 0, 2, 3, 8
"c:\Users\wadan\Desktop\SGA\Portfolio\Unreal\Project\UE_PUBG\Source\UE_PUBG\Item\ConsumableItem\Healing\C_FirstAidKit.cpp", "C++", 5, 0, 0, 3, 8
"c:\Users\wadan\Desktop\SGA\Portfolio\Unreal\Project\UE_PUBG\Source\UE_PUBG\Item\ConsumableItem\Healing\C_FirstAidKit.h", "C++", 1, 0, 1, 2, 4
"c:\Users\wadan\Desktop\SGA\Portfolio\Unreal\Project\UE_PUBG\Source\UE_PUBG\Item\ConsumableItem\Healing\C_MedKit.cpp", "C++", 4, 0, 0, 1, 5
"c:\Users\wadan\Desktop\SGA\Portfolio\Unreal\Project\UE_PUBG\Source\UE_PUBG\Item\ConsumableItem\Healing\C_MedKit.h", "C++", 1, 0, 1, 2, 4
"c:\Users\wadan\Desktop\SGA\Portfolio\Unreal\Project\UE_PUBG\Source\UE_PUBG\Item\Equipment\C_BackPack.cpp", "C++", 49, 0, 5, 19, 73
"c:\Users\wadan\Desktop\SGA\Portfolio\Unreal\Project\UE_PUBG\Source\UE_PUBG\Item\Equipment\C_BackPack.h", "C++", 1, 0, 2, 2, 5
"c:\Users\wadan\Desktop\SGA\Portfolio\Unreal\Project\UE_PUBG\Source\UE_PUBG\Item\Equipment\C_EquipableItem.cpp", "C++", 27, 0, 5, 6, 38
"c:\Users\wadan\Desktop\SGA\Portfolio\Unreal\Project\UE_PUBG\Source\UE_PUBG\Item\Equipment\C_EquipableItem.h", "C++", 16, 0, 1, 7, 24
"c:\Users\wadan\Desktop\SGA\Portfolio\Unreal\Project\UE_PUBG\Source\UE_PUBG\Item\Equipment\C_Helmet.cpp", "C++", 1, 0, 1, 4, 6
"c:\Users\wadan\Desktop\SGA\Portfolio\Unreal\Project\UE_PUBG\Source\UE_PUBG\Item\Equipment\C_Helmet.h", "C++", 11, 0, 4, 6, 21
"c:\Users\wadan\Desktop\SGA\Portfolio\Unreal\Project\UE_PUBG\Source\UE_PUBG\Item\Equipment\C_Vest.cpp", "C++", 48, 0, 7, 16, 71
"c:\Users\wadan\Desktop\SGA\Portfolio\Unreal\Project\UE_PUBG\Source\UE_PUBG\Item\Equipment\C_Vest.h", "C++", 17, 0, 4, 10, 31
"c:\Users\wadan\Desktop\SGA\Portfolio\Unreal\Project\UE_PUBG\Source\UE_PUBG\Item\Weapon\Gun\C_AR.cpp", "C++", 20, 0, 0, 3, 23
"c:\Users\wadan\Desktop\SGA\Portfolio\Unreal\Project\UE_PUBG\Source\UE_PUBG\Item\Weapon\Gun\C_AR.h", "C++", 1, 0, 0, -1, 0
"c:\Users\wadan\Desktop\SGA\Portfolio\Unreal\Project\UE_PUBG\Source\UE_PUBG\Item\Weapon\Gun\C_Bullet.cpp", "C++", -2, 0, 2, 0, 0
"c:\Users\wadan\Desktop\SGA\Portfolio\Unreal\Project\UE_PUBG\Source\UE_PUBG\Item\Weapon\Gun\C_Gun.cpp", "C++", 58, 0, 16, 7, 81
"c:\Users\wadan\Desktop\SGA\Portfolio\Unreal\Project\UE_PUBG\Source\UE_PUBG\Item\Weapon\Gun\C_Gun.h", "C++", 32, 0, 4, 5, 41
"c:\Users\wadan\Desktop\SGA\Portfolio\Unreal\Project\UE_PUBG\Source\UE_PUBG\Item\Weapon\Gun\C_SR.cpp", "C++", 83, 0, 5, 9, 97
"c:\Users\wadan\Desktop\SGA\Portfolio\Unreal\Project\UE_PUBG\Source\UE_PUBG\Item\Weapon\Gun\C_SR.h", "C++", 17, 0, 2, 1, 20
"c:\Users\wadan\Desktop\SGA\Portfolio\Unreal\Project\UE_PUBG\Source\UE_PUBG\Item\Weapon\MeleeWeapon\C_MeleeWeapon.cpp", "C++", 66, 0, 9, 18, 93
"c:\Users\wadan\Desktop\SGA\Portfolio\Unreal\Project\UE_PUBG\Source\UE_PUBG\Item\Weapon\MeleeWeapon\C_MeleeWeapon.h", "C++", 4, 0, 17, 4, 25
"c:\Users\wadan\Desktop\SGA\Portfolio\Unreal\Project\UE_PUBG\Source\UE_PUBG\Item\Weapon\ThrowingWeapon\C_ThrowingWeapon.cpp", "C++", 63, 0, 13, 31, 107
"c:\Users\wadan\Desktop\SGA\Portfolio\Unreal\Project\UE_PUBG\Source\UE_PUBG\Item\Weapon\ThrowingWeapon\C_ThrowingWeapon.h", "C++", 11, 0, 0, 3, 14
"c:\Users\wadan\Desktop\SGA\Portfolio\Unreal\Project\UE_PUBG\Source\UE_PUBG\Item\Weapon\WeaponStrategy\C_GunStrategy.cpp", "C++", 38, 0, 0, 2, 40
"c:\Users\wadan\Desktop\SGA\Portfolio\Unreal\Project\UE_PUBG\Source\UE_PUBG\Item\Weapon\WeaponStrategy\C_ThrowingWeaponStrategy.cpp", "C++", 1, 0, 0, 1, 2
"c:\Users\wadan\Desktop\SGA\Portfolio\Unreal\Project\UE_PUBG\Source\UE_PUBG\UE_PUBG.Build.cs", "C#", 0, 1, 0, 0, 1
"c:\Users\wadan\Desktop\SGA\Portfolio\Unreal\Project\UE_PUBG\Source\UE_PUBG\UE_PUBGGameMode.cpp", "C++", 2, 0, 0, 0, 2
"c:\Users\wadan\Desktop\SGA\Portfolio\Unreal\Project\UE_PUBG\Source\UE_PUBG\Utility\C_Util.h", "C++", 1, 0, 0, 0, 1
"Total", "-", 2107, 1, 600, 821, 3529