"filename", "language", "C++", "C#", "comment", "blank", "total"
"c:\Users\wadan\Desktop\SGA\Portfolio\Unreal\Project\UE_PUBG\Source\UE_PUBG\AI\C_BehaviorComponent.cpp", "C++", 50, 0, 2, 25, 77
"c:\Users\wadan\Desktop\SGA\Portfolio\Unreal\Project\UE_PUBG\Source\UE_PUBG\AI\C_BehaviorComponent.h", "C++", 55, 0, 7, 25, 87
"c:\Users\wadan\Desktop\SGA\Portfolio\Unreal\Project\UE_PUBG\Source\UE_PUBG\AI\C_EnemyAIController.cpp", "C++", 85, 0, 5, 32, 122
"c:\Users\wadan\Desktop\SGA\Portfolio\Unreal\Project\UE_PUBG\Source\UE_PUBG\AI\C_EnemyAIController.h", "C++", 24, 0, 8, 16, 48
"c:\Users\wadan\Desktop\SGA\Portfolio\Unreal\Project\UE_PUBG\Source\UE_PUBG\AI\Service\C_BTServiceCombat.cpp", "C++", 9, 0, 1, 9, 19
"c:\Users\wadan\Desktop\SGA\Portfolio\Unreal\Project\UE_PUBG\Source\UE_PUBG\AI\Service\C_BTServiceCombat.h", "C++", 12, 0, 4, 10, 26
"c:\Users\wadan\Desktop\SGA\Portfolio\Unreal\Project\UE_PUBG\Source\UE_PUBG\AI\Service\C_BTServiceIdle.cpp", "C++", 26, 0, 2, 15, 43
"c:\Users\wadan\Desktop\SGA\Portfolio\Unreal\Project\UE_PUBG\Source\UE_PUBG\AI\Service\C_BTServiceIdle.h", "C++", 20, 0, 4, 11, 35
"c:\Users\wadan\Desktop\SGA\Portfolio\Unreal\Project\UE_PUBG\Source\UE_PUBG\AI\Service\C_BTServiceSkyDive.cpp", "C++", 8, 0, 1, 9, 18
"c:\Users\wadan\Desktop\SGA\Portfolio\Unreal\Project\UE_PUBG\Source\UE_PUBG\AI\Service\C_BTServiceSkyDive.h", "C++", 12, 0, 4, 10, 26
"c:\Users\wadan\Desktop\SGA\Portfolio\Unreal\Project\UE_PUBG\Source\UE_PUBG\AI\Service\C_BTServiceStateMachine.cpp", "C++", 22, 0, 13, 17, 52
"c:\Users\wadan\Desktop\SGA\Portfolio\Unreal\Project\UE_PUBG\Source\UE_PUBG\AI\Service\C_BTServiceStateMachine.h", "C++", 18, 0, 4, 13, 35
"c:\Users\wadan\Desktop\SGA\Portfolio\Unreal\Project\UE_PUBG\Source\UE_PUBG\AI\Task\CombatTask\C_BTTaskAttack.cpp", "C++", 58, 0, 7, 24, 89
"c:\Users\wadan\Desktop\SGA\Portfolio\Unreal\Project\UE_PUBG\Source\UE_PUBG\AI\Task\CombatTask\C_BTTaskAttack.h", "C++", 17, 0, 5, 12, 34
"c:\Users\wadan\Desktop\SGA\Portfolio\Unreal\Project\UE_PUBG\Source\UE_PUBG\AI\Task\CombatTask\C_BTTaskSwapWeapon.cpp", "C++", 50, 0, 22, 26, 98
"c:\Users\wadan\Desktop\SGA\Portfolio\Unreal\Project\UE_PUBG\Source\UE_PUBG\AI\Task\CombatTask\C_BTTaskSwapWeapon.h", "C++", 17, 0, 4, 13, 34
"c:\Users\wadan\Desktop\SGA\Portfolio\Unreal\Project\UE_PUBG\Source\UE_PUBG\AI\Task\IdleTask\C_BTTaskChangePose.cpp", "C++", 45, 0, 3, 20, 68
"c:\Users\wadan\Desktop\SGA\Portfolio\Unreal\Project\UE_PUBG\Source\UE_PUBG\AI\Task\IdleTask\C_BTTaskChangePose.h", "C++", 17, 0, 4, 14, 35
"c:\Users\wadan\Desktop\SGA\Portfolio\Unreal\Project\UE_PUBG\Source\UE_PUBG\AI\Task\SkyDiveTask\C_BTTaskSkyDive.cpp", "C++", 13, 0, 2, 9, 24
"c:\Users\wadan\Desktop\SGA\Portfolio\Unreal\Project\UE_PUBG\Source\UE_PUBG\AI\Task\SkyDiveTask\C_BTTaskSkyDive.h", "C++", 15, 0, 10, 15, 40
"c:\Users\wadan\Desktop\SGA\Portfolio\Unreal\Project\UE_PUBG\Source\UE_PUBG\Airplane\C_Airplane.cpp", "C++", 82, 0, 12, 36, 130
"c:\Users\wadan\Desktop\SGA\Portfolio\Unreal\Project\UE_PUBG\Source\UE_PUBG\Airplane\C_Airplane.h", "C++", 39, 0, 16, 29, 84
"c:\Users\wadan\Desktop\SGA\Portfolio\Unreal\Project\UE_PUBG\Source\UE_PUBG\Airplane\C_AirplaneManager.cpp", "C++", 207, 0, 30, 68, 305
"c:\Users\wadan\Desktop\SGA\Portfolio\Unreal\Project\UE_PUBG\Source\UE_PUBG\Airplane\C_AirplaneManager.h", "C++", 48, 0, 35, 39, 122
"c:\Users\wadan\Desktop\SGA\Portfolio\Unreal\Project\UE_PUBG\Source\UE_PUBG\C_MyMotionWarpingComponent.cpp", "C++", 1, 0, 1, 6, 8
"c:\Users\wadan\Desktop\SGA\Portfolio\Unreal\Project\UE_PUBG\Source\UE_PUBG\C_MyMotionWarpingComponent.h", "C++", 9, 0, 4, 8, 21
"c:\Users\wadan\Desktop\SGA\Portfolio\Unreal\Project\UE_PUBG\Source\UE_PUBG\Character\C_AnimBasicCharacter.cpp", "C++", 201, 0, 50, 59, 310
"c:\Users\wadan\Desktop\SGA\Portfolio\Unreal\Project\UE_PUBG\Source\UE_PUBG\Character\C_AnimBasicCharacter.h", "C++", 107, 0, 8, 52, 167
"c:\Users\wadan\Desktop\SGA\Portfolio\Unreal\Project\UE_PUBG\Source\UE_PUBG\Character\C_AnimEnemy.cpp", "C++", 7, 0, 1, 8, 16
"c:\Users\wadan\Desktop\SGA\Portfolio\Unreal\Project\UE_PUBG\Source\UE_PUBG\Character\C_AnimEnemy.h", "C++", 11, 0, 7, 9, 27
"c:\Users\wadan\Desktop\SGA\Portfolio\Unreal\Project\UE_PUBG\Source\UE_PUBG\Character\C_AnimPlayer.cpp", "C++", 42, 0, 1, 18, 61
"c:\Users\wadan\Desktop\SGA\Portfolio\Unreal\Project\UE_PUBG\Source\UE_PUBG\Character\C_AnimPlayer.h", "C++", 14, 0, 4, 12, 30
"c:\Users\wadan\Desktop\SGA\Portfolio\Unreal\Project\UE_PUBG\Source\UE_PUBG\Character\C_BasicCharacter.cpp", "C++", 315, 0, 63, 96, 474
"c:\Users\wadan\Desktop\SGA\Portfolio\Unreal\Project\UE_PUBG\Source\UE_PUBG\Character\C_BasicCharacter.h", "C++", 270, 0, 76, 124, 470
"c:\Users\wadan\Desktop\SGA\Portfolio\Unreal\Project\UE_PUBG\Source\UE_PUBG\Character\C_Enemy.cpp", "C++", 113, 0, 20, 48, 181
"c:\Users\wadan\Desktop\SGA\Portfolio\Unreal\Project\UE_PUBG\Source\UE_PUBG\Character\C_Enemy.h", "C++", 25, 0, 8, 21, 54
"c:\Users\wadan\Desktop\SGA\Portfolio\Unreal\Project\UE_PUBG\Source\UE_PUBG\Character\C_Player.cpp", "C++", 758, 0, 218, 230, 1206
"c:\Users\wadan\Desktop\SGA\Portfolio\Unreal\Project\UE_PUBG\Source\UE_PUBG\Character\C_Player.h", "C++", 155, 0, 88, 94, 337
"c:\Users\wadan\Desktop\SGA\Portfolio\Unreal\Project\UE_PUBG\Source\UE_PUBG\Character\C_WorldPingActor.cpp", "C++", 54, 0, 3, 29, 86
"c:\Users\wadan\Desktop\SGA\Portfolio\Unreal\Project\UE_PUBG\Source\UE_PUBG\Character\C_WorldPingActor.h", "C++", 25, 0, 3, 20, 48
"c:\Users\wadan\Desktop\SGA\Portfolio\Unreal\Project\UE_PUBG\Source\UE_PUBG\Character\Component\C_AttachableItemMeshComponent.cpp", "C++", 158, 0, 34, 46, 238
"c:\Users\wadan\Desktop\SGA\Portfolio\Unreal\Project\UE_PUBG\Source\UE_PUBG\Character\Component\C_AttachableItemMeshComponent.h", "C++", 26, 0, 6, 13, 45
"c:\Users\wadan\Desktop\SGA\Portfolio\Unreal\Project\UE_PUBG\Source\UE_PUBG\Character\Component\C_CameraEffectComponent.cpp", "C++", 146, 0, 24, 60, 230
"c:\Users\wadan\Desktop\SGA\Portfolio\Unreal\Project\UE_PUBG\Source\UE_PUBG\Character\Component\C_CameraEffectComponent.h", "C++", 60, 0, 29, 39, 128
"c:\Users\wadan\Desktop\SGA\Portfolio\Unreal\Project\UE_PUBG\Source\UE_PUBG\Character\Component\C_ConsumableUsageMeshComponent.cpp", "C++", 60, 0, 10, 23, 93
"c:\Users\wadan\Desktop\SGA\Portfolio\Unreal\Project\UE_PUBG\Source\UE_PUBG\Character\Component\C_ConsumableUsageMeshComponent.h", "C++", 36, 0, 10, 23, 69
"c:\Users\wadan\Desktop\SGA\Portfolio\Unreal\Project\UE_PUBG\Source\UE_PUBG\Character\Component\C_CrosshairWidgetComponent.cpp", "C++", 192, 0, 13, 38, 243
"c:\Users\wadan\Desktop\SGA\Portfolio\Unreal\Project\UE_PUBG\Source\UE_PUBG\Character\Component\C_CrosshairWidgetComponent.h", "C++", 64, 0, 8, 12, 84
"c:\Users\wadan\Desktop\SGA\Portfolio\Unreal\Project\UE_PUBG\Source\UE_PUBG\Character\Component\C_EquippedComponent.cpp", "C++", 271, 0, 47, 92, 410
"c:\Users\wadan\Desktop\SGA\Portfolio\Unreal\Project\UE_PUBG\Source\UE_PUBG\Character\Component\C_EquippedComponent.h", "C++", 75, 0, 51, 49, 175
"c:\Users\wadan\Desktop\SGA\Portfolio\Unreal\Project\UE_PUBG\Source\UE_PUBG\Character\Component\C_InputComponent.cpp", "C++", 446, 0, 89, 145, 680
"c:\Users\wadan\Desktop\SGA\Portfolio\Unreal\Project\UE_PUBG\Source\UE_PUBG\Character\Component\C_InputComponent.h", "C++", 105, 0, 19, 58, 182
"c:\Users\wadan\Desktop\SGA\Portfolio\Unreal\Project\UE_PUBG\Source\UE_PUBG\Character\Component\C_InvenComponent.cpp", "C++", 224, 0, 252, 79, 555
"c:\Users\wadan\Desktop\SGA\Portfolio\Unreal\Project\UE_PUBG\Source\UE_PUBG\Character\Component\C_InvenComponent.h", "C++", 102, 0, 53, 62, 217
"c:\Users\wadan\Desktop\SGA\Portfolio\Unreal\Project\UE_PUBG\Source\UE_PUBG\Character\Component\C_InvenSystem.cpp", "C++", 89, 0, 34, 40, 163
"c:\Users\wadan\Desktop\SGA\Portfolio\Unreal\Project\UE_PUBG\Source\UE_PUBG\Character\Component\C_InvenSystem.h", "C++", 37, 0, 24, 22, 83
"c:\Users\wadan\Desktop\SGA\Portfolio\Unreal\Project\UE_PUBG\Source\UE_PUBG\Character\Component\C_ParkourComponent.cpp", "C++", 500, 0, 90, 162, 752
"c:\Users\wadan\Desktop\SGA\Portfolio\Unreal\Project\UE_PUBG\Source\UE_PUBG\Character\Component\C_ParkourComponent.h", "C++", 107, 0, 80, 73, 260
"c:\Users\wadan\Desktop\SGA\Portfolio\Unreal\Project\UE_PUBG\Source\UE_PUBG\Character\Component\C_PingSystemComponent.cpp", "C++", 48, 0, 3, 25, 76
"c:\Users\wadan\Desktop\SGA\Portfolio\Unreal\Project\UE_PUBG\Source\UE_PUBG\Character\Component\C_PingSystemComponent.h", "C++", 28, 0, 10, 27, 65
"c:\Users\wadan\Desktop\SGA\Portfolio\Unreal\Project\UE_PUBG\Source\UE_PUBG\Character\Component\C_PlayerController.cpp", "C++", 14, 0, 41, 8, 63
"c:\Users\wadan\Desktop\SGA\Portfolio\Unreal\Project\UE_PUBG\Source\UE_PUBG\Character\Component\C_PlayerController.h", "C++", 11, 0, 9, 8, 28
"c:\Users\wadan\Desktop\SGA\Portfolio\Unreal\Project\UE_PUBG\Source\UE_PUBG\Character\Component\C_PoseColliderHandlerComponent.cpp", "C++", 249, 0, 49, 96, 394
"c:\Users\wadan\Desktop\SGA\Portfolio\Unreal\Project\UE_PUBG\Source\UE_PUBG\Character\Component\C_PoseColliderHandlerComponent.h", "C++", 59, 0, 66, 51, 176
"c:\Users\wadan\Desktop\SGA\Portfolio\Unreal\Project\UE_PUBG\Source\UE_PUBG\Character\Component\C_SkyDivingComponent.cpp", "C++", 283, 0, 58, 98, 439
"c:\Users\wadan\Desktop\SGA\Portfolio\Unreal\Project\UE_PUBG\Source\UE_PUBG\Character\Component\C_SkyDivingComponent.h", "C++", 109, 0, 40, 60, 209
"c:\Users\wadan\Desktop\SGA\Portfolio\Unreal\Project\UE_PUBG\Source\UE_PUBG\Character\Component\C_StatComponent.cpp", "C++", 191, 0, 13, 68, 272
"c:\Users\wadan\Desktop\SGA\Portfolio\Unreal\Project\UE_PUBG\Source\UE_PUBG\Character\Component\C_StatComponent.h", "C++", 89, 0, 44, 50, 183
"c:\Users\wadan\Desktop\SGA\Portfolio\Unreal\Project\UE_PUBG\Source\UE_PUBG\Character\Component\C_SwimmingComponent.cpp", "C++", 273, 0, 48, 98, 419
"c:\Users\wadan\Desktop\SGA\Portfolio\Unreal\Project\UE_PUBG\Source\UE_PUBG\Character\Component\C_SwimmingComponent.h", "C++", 72, 0, 24, 42, 138
"c:\Users\wadan\Desktop\SGA\Portfolio\Unreal\Project\UE_PUBG\Source\UE_PUBG\Character\Component\ParkourActionStrategy\C_MantleHighActionStrategy.cpp", "C++", 41, 0, 5, 29, 75
"c:\Users\wadan\Desktop\SGA\Portfolio\Unreal\Project\UE_PUBG\Source\UE_PUBG\Character\Component\ParkourActionStrategy\C_MantleHighActionStrategy.h", "C++", 12, 0, 4, 9, 25
"c:\Users\wadan\Desktop\SGA\Portfolio\Unreal\Project\UE_PUBG\Source\UE_PUBG\Character\Component\ParkourActionStrategy\C_MantleLowActionStrategy.cpp", "C++", 26, 0, 3, 20, 49
"c:\Users\wadan\Desktop\SGA\Portfolio\Unreal\Project\UE_PUBG\Source\UE_PUBG\Character\Component\ParkourActionStrategy\C_MantleLowActionStrategy.h", "C++", 12, 0, 4, 9, 25
"c:\Users\wadan\Desktop\SGA\Portfolio\Unreal\Project\UE_PUBG\Source\UE_PUBG\Character\Component\ParkourActionStrategy\C_VaultHighActionStrategy.cpp", "C++", 43, 0, 6, 30, 79
"c:\Users\wadan\Desktop\SGA\Portfolio\Unreal\Project\UE_PUBG\Source\UE_PUBG\Character\Component\ParkourActionStrategy\C_VaultHighActionStrategy.h", "C++", 12, 0, 4, 8, 24
"c:\Users\wadan\Desktop\SGA\Portfolio\Unreal\Project\UE_PUBG\Source\UE_PUBG\Character\Component\ParkourActionStrategy\C_VaultLowActionStrategy.cpp", "C++", 45, 0, 7, 28, 80
"c:\Users\wadan\Desktop\SGA\Portfolio\Unreal\Project\UE_PUBG\Source\UE_PUBG\Character\Component\ParkourActionStrategy\C_VaultLowActionStrategy.h", "C++", 12, 0, 4, 9, 25
"c:\Users\wadan\Desktop\SGA\Portfolio\Unreal\Project\UE_PUBG\Source\UE_PUBG\Character\Component\ParkourActionStrategy\I_ParkourActionStrategy.cpp", "C++", 1, 0, 2, 6, 9
"c:\Users\wadan\Desktop\SGA\Portfolio\Unreal\Project\UE_PUBG\Source\UE_PUBG\Character\Component\ParkourActionStrategy\I_ParkourActionStrategy.h", "C++", 15, 0, 10, 11, 36
"c:\Users\wadan\Desktop\SGA\Portfolio\Unreal\Project\UE_PUBG\Source\UE_PUBG\HUD\C_AmmoWidget.cpp", "C++", 282, 0, 22, 77, 381
"c:\Users\wadan\Desktop\SGA\Portfolio\Unreal\Project\UE_PUBG\Source\UE_PUBG\HUD\C_AmmoWidget.h", "C++", 70, 0, 30, 48, 148
"c:\Users\wadan\Desktop\SGA\Portfolio\Unreal\Project\UE_PUBG\Source\UE_PUBG\HUD\C_ArmorInfoWidget.cpp", "C++", 158, 0, 8, 42, 208
"c:\Users\wadan\Desktop\SGA\Portfolio\Unreal\Project\UE_PUBG\Source\UE_PUBG\HUD\C_ArmorInfoWidget.h", "C++", 32, 0, 38, 21, 91
"c:\Users\wadan\Desktop\SGA\Portfolio\Unreal\Project\UE_PUBG\Source\UE_PUBG\HUD\C_BloodScreenWidget.cpp", "C++", 7, 0, 1, 4, 12
"c:\Users\wadan\Desktop\SGA\Portfolio\Unreal\Project\UE_PUBG\Source\UE_PUBG\HUD\C_BloodScreenWidget.h", "C++", 15, 0, 5, 8, 28
"c:\Users\wadan\Desktop\SGA\Portfolio\Unreal\Project\UE_PUBG\Source\UE_PUBG\HUD\C_HUDWidget.cpp", "C++", 12, 0, 1, 11, 24
"c:\Users\wadan\Desktop\SGA\Portfolio\Unreal\Project\UE_PUBG\Source\UE_PUBG\HUD\C_HUDWidget.h", "C++", 81, 0, 40, 53, 174
"c:\Users\wadan\Desktop\SGA\Portfolio\Unreal\Project\UE_PUBG\Source\UE_PUBG\HUD\C_InstructionWidget.cpp", "C++", 30, 0, 3, 18, 51
"c:\Users\wadan\Desktop\SGA\Portfolio\Unreal\Project\UE_PUBG\Source\UE_PUBG\HUD\C_InstructionWidget.h", "C++", 26, 0, 4, 18, 48
"c:\Users\wadan\Desktop\SGA\Portfolio\Unreal\Project\UE_PUBG\Source\UE_PUBG\HUD\C_MainMapWidget.cpp", "C++", 286, 0, 59, 108, 453
"c:\Users\wadan\Desktop\SGA\Portfolio\Unreal\Project\UE_PUBG\Source\UE_PUBG\HUD\C_MainMapWidget.h", "C++", 60, 0, 43, 45, 148
"c:\Users\wadan\Desktop\SGA\Portfolio\Unreal\Project\UE_PUBG\Source\UE_PUBG\HUD\C_MapWidget.cpp", "C++", 105, 0, 20, 45, 170
"c:\Users\wadan\Desktop\SGA\Portfolio\Unreal\Project\UE_PUBG\Source\UE_PUBG\HUD\C_MapWidget.h", "C++", 64, 0, 63, 51, 178
"c:\Users\wadan\Desktop\SGA\Portfolio\Unreal\Project\UE_PUBG\Source\UE_PUBG\HUD\C_OxygenWidget.cpp", "C++", 1, 0, 1, 6, 8
"c:\Users\wadan\Desktop\SGA\Portfolio\Unreal\Project\UE_PUBG\Source\UE_PUBG\HUD\C_OxygenWidget.h", "C++", 12, 0, 7, 10, 29
"c:\Users\wadan\Desktop\SGA\Portfolio\Unreal\Project\UE_PUBG\Source\UE_PUBG\HUD\C_SkyDiveWidget.cpp", "C++", 79, 0, 10, 36, 125
"c:\Users\wadan\Desktop\SGA\Portfolio\Unreal\Project\UE_PUBG\Source\UE_PUBG\HUD\C_SkyDiveWidget.h", "C++", 48, 0, 12, 33, 93
"c:\Users\wadan\Desktop\SGA\Portfolio\Unreal\Project\UE_PUBG\Source\UE_PUBG\InvenUI\BasicItemSlot\C_BasicEquippedItemSlotWidget.cpp", "C++", 4, 0, 17, 7, 28
"c:\Users\wadan\Desktop\SGA\Portfolio\Unreal\Project\UE_PUBG\Source\UE_PUBG\InvenUI\BasicItemSlot\C_BasicEquippedItemSlotWidget.h", "C++", 11, 0, 5, 7, 23
"c:\Users\wadan\Desktop\SGA\Portfolio\Unreal\Project\UE_PUBG\Source\UE_PUBG\InvenUI\BasicItemSlot\EquipmentSlot\C_AttachableItemSlotWidget.cpp", "C++", 100, 0, 61, 44, 205
"c:\Users\wadan\Desktop\SGA\Portfolio\Unreal\Project\UE_PUBG\Source\UE_PUBG\InvenUI\BasicItemSlot\EquipmentSlot\C_AttachableItemSlotWidget.h", "C++", 22, 0, 31, 15, 68
"c:\Users\wadan\Desktop\SGA\Portfolio\Unreal\Project\UE_PUBG\Source\UE_PUBG\InvenUI\BasicItemSlot\EquipmentSlot\C_BackPackSlotWidget.cpp", "C++", 3, 0, 36, 6, 45
"c:\Users\wadan\Desktop\SGA\Portfolio\Unreal\Project\UE_PUBG\Source\UE_PUBG\InvenUI\BasicItemSlot\EquipmentSlot\C_BackPackSlotWidget.h", "C++", 10, 0, 6, 8, 24
"c:\Users\wadan\Desktop\SGA\Portfolio\Unreal\Project\UE_PUBG\Source\UE_PUBG\InvenUI\BasicItemSlot\EquipmentSlot\C_EquipmentSlotWidget.cpp", "C++", 85, 0, 44, 34, 163
"c:\Users\wadan\Desktop\SGA\Portfolio\Unreal\Project\UE_PUBG\Source\UE_PUBG\InvenUI\BasicItemSlot\EquipmentSlot\C_EquipmentSlotWidget.h", "C++", 24, 0, 23, 15, 62
"c:\Users\wadan\Desktop\SGA\Portfolio\Unreal\Project\UE_PUBG\Source\UE_PUBG\InvenUI\BasicItemSlot\EquipmentSlot\C_HelmetSlotWidget.cpp", "C++", 3, 0, 35, 7, 45
"c:\Users\wadan\Desktop\SGA\Portfolio\Unreal\Project\UE_PUBG\Source\UE_PUBG\InvenUI\BasicItemSlot\EquipmentSlot\C_HelmetSlotWidget.h", "C++", 10, 0, 5, 8, 23
"c:\Users\wadan\Desktop\SGA\Portfolio\Unreal\Project\UE_PUBG\Source\UE_PUBG\InvenUI\BasicItemSlot\EquipmentSlot\C_VestSlotWidget.cpp", "C++", 3, 0, 37, 6, 46
"c:\Users\wadan\Desktop\SGA\Portfolio\Unreal\Project\UE_PUBG\Source\UE_PUBG\InvenUI\BasicItemSlot\EquipmentSlot\C_VestSlotWidget.h", "C++", 10, 0, 5, 8, 23
"c:\Users\wadan\Desktop\SGA\Portfolio\Unreal\Project\UE_PUBG\Source\UE_PUBG\InvenUI\BasicItemSlot\WeaponSlot\C_MeleeWeaponSlotWidget.cpp", "C++", 6, 0, 29, 7, 42
"c:\Users\wadan\Desktop\SGA\Portfolio\Unreal\Project\UE_PUBG\Source\UE_PUBG\InvenUI\BasicItemSlot\WeaponSlot\C_MeleeWeaponSlotWidget.h", "C++", 11, 0, 6, 8, 25
"c:\Users\wadan\Desktop\SGA\Portfolio\Unreal\Project\UE_PUBG\Source\UE_PUBG\InvenUI\BasicItemSlot\WeaponSlot\C_ThrowableWeaponSlotWidget.cpp", "C++", 6, 0, 33, 7, 46
"c:\Users\wadan\Desktop\SGA\Portfolio\Unreal\Project\UE_PUBG\Source\UE_PUBG\InvenUI\BasicItemSlot\WeaponSlot\C_ThrowableWeaponSlotWidget.h", "C++", 11, 0, 9, 6, 26
"c:\Users\wadan\Desktop\SGA\Portfolio\Unreal\Project\UE_PUBG\Source\UE_PUBG\InvenUI\BasicItemSlot\WeaponSlot\C_WeaponSlotWidget.cpp", "C++", 89, 0, 40, 39, 168
"c:\Users\wadan\Desktop\SGA\Portfolio\Unreal\Project\UE_PUBG\Source\UE_PUBG\InvenUI\BasicItemSlot\WeaponSlot\C_WeaponSlotWidget.h", "C++", 33, 0, 40, 21, 94
"c:\Users\wadan\Desktop\SGA\Portfolio\Unreal\Project\UE_PUBG\Source\UE_PUBG\InvenUI\BasicItemSlot\WeaponSlot\GunSlot\C_GunSlotWidget.cpp", "C++", 147, 0, 91, 60, 298
"c:\Users\wadan\Desktop\SGA\Portfolio\Unreal\Project\UE_PUBG\Source\UE_PUBG\InvenUI\BasicItemSlot\WeaponSlot\GunSlot\C_GunSlotWidget.h", "C++", 34, 0, 11, 23, 68
"c:\Users\wadan\Desktop\SGA\Portfolio\Unreal\Project\UE_PUBG\Source\UE_PUBG\InvenUI\BasicItemSlot\WeaponSlot\GunSlot\C_MainGunSlotWidget.cpp", "C++", 16, 0, 30, 11, 57
"c:\Users\wadan\Desktop\SGA\Portfolio\Unreal\Project\UE_PUBG\Source\UE_PUBG\InvenUI\BasicItemSlot\WeaponSlot\GunSlot\C_MainGunSlotWidget.h", "C++", 12, 0, 8, 12, 32
"c:\Users\wadan\Desktop\SGA\Portfolio\Unreal\Project\UE_PUBG\Source\UE_PUBG\InvenUI\BasicItemSlot\WeaponSlot\GunSlot\C_SubGunSlotWidget.cpp", "C++", 16, 0, 29, 10, 55
"c:\Users\wadan\Desktop\SGA\Portfolio\Unreal\Project\UE_PUBG\Source\UE_PUBG\InvenUI\BasicItemSlot\WeaponSlot\GunSlot\C_SubGunSlotWidget.h", "C++", 12, 0, 7, 9, 28
"c:\Users\wadan\Desktop\SGA\Portfolio\Unreal\Project\UE_PUBG\Source\UE_PUBG\InvenUI\C_CustomUserWidget.cpp", "C++", 1, 0, 1, 6, 8
"c:\Users\wadan\Desktop\SGA\Portfolio\Unreal\Project\UE_PUBG\Source\UE_PUBG\InvenUI\C_CustomUserWidget.h", "C++", 18, 0, 4, 9, 31
"c:\Users\wadan\Desktop\SGA\Portfolio\Unreal\Project\UE_PUBG\Source\UE_PUBG\InvenUI\C_InventoryUIWidget.cpp", "C++", 84, 0, 42, 37, 163
"c:\Users\wadan\Desktop\SGA\Portfolio\Unreal\Project\UE_PUBG\Source\UE_PUBG\InvenUI\C_InventoryUIWidget.h", "C++", 34, 0, 20, 26, 80
"c:\Users\wadan\Desktop\SGA\Portfolio\Unreal\Project\UE_PUBG\Source\UE_PUBG\InvenUI\ItemBar\C_BasicItemBarWidget.cpp", "C++", 126, 0, 34, 58, 218
"c:\Users\wadan\Desktop\SGA\Portfolio\Unreal\Project\UE_PUBG\Source\UE_PUBG\InvenUI\ItemBar\C_BasicItemBarWidget.h", "C++", 34, 0, 34, 21, 89
"c:\Users\wadan\Desktop\SGA\Portfolio\Unreal\Project\UE_PUBG\Source\UE_PUBG\InvenUI\Panel\C_BasicPanelWidget.cpp", "C++", 35, 0, 4, 12, 51
"c:\Users\wadan\Desktop\SGA\Portfolio\Unreal\Project\UE_PUBG\Source\UE_PUBG\InvenUI\Panel\C_BasicPanelWidget.h", "C++", 13, 0, 4, 7, 24
"c:\Users\wadan\Desktop\SGA\Portfolio\Unreal\Project\UE_PUBG\Source\UE_PUBG\InvenUI\Panel\ItemPanel\C_AroundItemPanelWidget.cpp", "C++", 7, 0, 1, 5, 13
"c:\Users\wadan\Desktop\SGA\Portfolio\Unreal\Project\UE_PUBG\Source\UE_PUBG\InvenUI\Panel\ItemPanel\C_AroundItemPanelWidget.h", "C++", 11, 0, 4, 8, 23
"c:\Users\wadan\Desktop\SGA\Portfolio\Unreal\Project\UE_PUBG\Source\UE_PUBG\InvenUI\Panel\ItemPanel\C_BasicItemPanelWidget.cpp", "C++", 96, 0, 5, 25, 126
"c:\Users\wadan\Desktop\SGA\Portfolio\Unreal\Project\UE_PUBG\Source\UE_PUBG\InvenUI\Panel\ItemPanel\C_BasicItemPanelWidget.h", "C++", 20, 0, 13, 11, 44
"c:\Users\wadan\Desktop\SGA\Portfolio\Unreal\Project\UE_PUBG\Source\UE_PUBG\InvenUI\Panel\ItemPanel\C_InventoryItemPanelWidget.cpp", "C++", 7, 0, 1, 7, 15
"c:\Users\wadan\Desktop\SGA\Portfolio\Unreal\Project\UE_PUBG\Source\UE_PUBG\InvenUI\Panel\ItemPanel\C_InventoryItemPanelWidget.h", "C++", 11, 0, 4, 7, 22
"c:\Users\wadan\Desktop\SGA\Portfolio\Unreal\Project\UE_PUBG\Source\UE_PUBG\InvenUI\Panel\ItemPanel\EquipmentPanel\C_EquipmentPanelWdiget.cpp", "C++", 62, 0, 4, 30, 96
"c:\Users\wadan\Desktop\SGA\Portfolio\Unreal\Project\UE_PUBG\Source\UE_PUBG\InvenUI\Panel\ItemPanel\EquipmentPanel\C_EquipmentPanelWdiget.h", "C++", 30, 0, 4, 16, 50
"c:\Users\wadan\Desktop\SGA\Portfolio\Unreal\Project\UE_PUBG\Source\UE_PUBG\InvenUserInterface\C_BasicSlotWidget.cpp", "C++", 57, 0, 14, 32, 103
"c:\Users\wadan\Desktop\SGA\Portfolio\Unreal\Project\UE_PUBG\Source\UE_PUBG\InvenUserInterface\C_BasicSlotWidget.h", "C++", 23, 0, 5, 14, 42
"c:\Users\wadan\Desktop\SGA\Portfolio\Unreal\Project\UE_PUBG\Source\UE_PUBG\InvenUserInterface\C_BasicUserWidget.cpp", "C++", 1, 0, 1, 6, 8
"c:\Users\wadan\Desktop\SGA\Portfolio\Unreal\Project\UE_PUBG\Source\UE_PUBG\InvenUserInterface\C_BasicUserWidget.h", "C++", 9, 0, 4, 7, 20
"c:\Users\wadan\Desktop\SGA\Portfolio\Unreal\Project\UE_PUBG\Source\UE_PUBG\InvenUserInterface\C_CustomListView.cpp", "C++", 11, 0, 9, 9, 29
"c:\Users\wadan\Desktop\SGA\Portfolio\Unreal\Project\UE_PUBG\Source\UE_PUBG\InvenUserInterface\C_CustomListView.h", "C++", 19, 0, 5, 12, 36
"c:\Users\wadan\Desktop\SGA\Portfolio\Unreal\Project\UE_PUBG\Source\UE_PUBG\InvenUserInterface\C_DragDropOperation.cpp", "C++", 1, 0, 1, 6, 8
"c:\Users\wadan\Desktop\SGA\Portfolio\Unreal\Project\UE_PUBG\Source\UE_PUBG\InvenUserInterface\C_DragDropOperation.h", "C++", 22, 0, 5, 11, 38
"c:\Users\wadan\Desktop\SGA\Portfolio\Unreal\Project\UE_PUBG\Source\UE_PUBG\InvenUserInterface\C_EquipSlot.cpp", "C++", 68, 0, 12, 15, 95
"c:\Users\wadan\Desktop\SGA\Portfolio\Unreal\Project\UE_PUBG\Source\UE_PUBG\InvenUserInterface\C_EquipSlot.h", "C++", 21, 0, 16, 15, 52
"c:\Users\wadan\Desktop\SGA\Portfolio\Unreal\Project\UE_PUBG\Source\UE_PUBG\InvenUserInterface\C_EquipmentPanel.cpp", "C++", 40, 0, 1, 12, 53
"c:\Users\wadan\Desktop\SGA\Portfolio\Unreal\Project\UE_PUBG\Source\UE_PUBG\InvenUserInterface\C_EquipmentPanel.h", "C++", 37, 0, 4, 20, 61
"c:\Users\wadan\Desktop\SGA\Portfolio\Unreal\Project\UE_PUBG\Source\UE_PUBG\InvenUserInterface\C_InvenUiWidget.cpp", "C++", 178, 0, 51, 75, 304
"c:\Users\wadan\Desktop\SGA\Portfolio\Unreal\Project\UE_PUBG\Source\UE_PUBG\InvenUserInterface\C_InvenUiWidget.h", "C++", 67, 0, 15, 41, 123
"c:\Users\wadan\Desktop\SGA\Portfolio\Unreal\Project\UE_PUBG\Source\UE_PUBG\InvenUserInterface\C_ItemBarWidget.cpp", "C++", 170, 0, 81, 68, 319
"c:\Users\wadan\Desktop\SGA\Portfolio\Unreal\Project\UE_PUBG\Source\UE_PUBG\InvenUserInterface\C_ItemBarWidget.h", "C++", 48, 0, 18, 28, 94
"c:\Users\wadan\Desktop\SGA\Portfolio\Unreal\Project\UE_PUBG\Source\UE_PUBG\InvenUserInterface\C_MainGunWidget.cpp", "C++", 112, 0, 17, 41, 170
"c:\Users\wadan\Desktop\SGA\Portfolio\Unreal\Project\UE_PUBG\Source\UE_PUBG\InvenUserInterface\C_MainGunWidget.h", "C++", 31, 0, 12, 21, 64
"c:\Users\wadan\Desktop\SGA\Portfolio\Unreal\Project\UE_PUBG\Source\UE_PUBG\InvenUserInterface\C_MyItemListWidget.cpp", "C++", 82, 0, 6, 22, 110
"c:\Users\wadan\Desktop\SGA\Portfolio\Unreal\Project\UE_PUBG\Source\UE_PUBG\InvenUserInterface\C_MyItemListWidget.h", "C++", 25, 0, 14, 16, 55
"c:\Users\wadan\Desktop\SGA\Portfolio\Unreal\Project\UE_PUBG\Source\UE_PUBG\InvenUserInterface\C_ThrowableWidget.cpp", "C++", 102, 0, 4, 19, 125
"c:\Users\wadan\Desktop\SGA\Portfolio\Unreal\Project\UE_PUBG\Source\UE_PUBG\InvenUserInterface\C_ThrowableWidget.h", "C++", 32, 0, 10, 22, 64
"c:\Users\wadan\Desktop\SGA\Portfolio\Unreal\Project\UE_PUBG\Source\UE_PUBG\Item\AttachmentActors\AttachmentActor.cpp", "C++", 13, 0, 5, 12, 30
"c:\Users\wadan\Desktop\SGA\Portfolio\Unreal\Project\UE_PUBG\Source\UE_PUBG\Item\AttachmentActors\AttachmentActor.h", "C++", 32, 0, 4, 9, 45
"c:\Users\wadan\Desktop\SGA\Portfolio\Unreal\Project\UE_PUBG\Source\UE_PUBG\Item\AttachmentActors\C_Attachment_Compensator.cpp", "C++", 46, 0, 1, 12, 59
"c:\Users\wadan\Desktop\SGA\Portfolio\Unreal\Project\UE_PUBG\Source\UE_PUBG\Item\AttachmentActors\C_Attachment_Compensator.h", "C++", 18, 0, 7, 9, 34
"c:\Users\wadan\Desktop\SGA\Portfolio\Unreal\Project\UE_PUBG\Source\UE_PUBG\Item\AttachmentActors\C_Attachment_RedDot.cpp", "C++", 42, 0, 1, 15, 58
"c:\Users\wadan\Desktop\SGA\Portfolio\Unreal\Project\UE_PUBG\Source\UE_PUBG\Item\AttachmentActors\C_Attachment_RedDot.h", "C++", 17, 0, 7, 8, 32
"c:\Users\wadan\Desktop\SGA\Portfolio\Unreal\Project\UE_PUBG\Source\UE_PUBG\Item\AttachmentActors\C_Attachment_Scope4X.cpp", "C++", 61, 0, 2, 13, 76
"c:\Users\wadan\Desktop\SGA\Portfolio\Unreal\Project\UE_PUBG\Source\UE_PUBG\Item\AttachmentActors\C_Attachment_Scope4X.h", "C++", 19, 0, 7, 9, 35
"c:\Users\wadan\Desktop\SGA\Portfolio\Unreal\Project\UE_PUBG\Source\UE_PUBG\Item\AttachmentActors\C_Attachment_VertGrip.cpp", "C++", 47, 0, 1, 14, 62
"c:\Users\wadan\Desktop\SGA\Portfolio\Unreal\Project\UE_PUBG\Source\UE_PUBG\Item\AttachmentActors\C_Attachment_VertGrip.h", "C++", 18, 0, 7, 9, 34
"c:\Users\wadan\Desktop\SGA\Portfolio\Unreal\Project\UE_PUBG\Source\UE_PUBG\Item\Attachment\C_AttachableItem.cpp", "C++", 164, 0, 32, 81, 277
"c:\Users\wadan\Desktop\SGA\Portfolio\Unreal\Project\UE_PUBG\Source\UE_PUBG\Item\Attachment\C_AttachableItem.h", "C++", 44, 0, 5, 31, 80
"c:\Users\wadan\Desktop\SGA\Portfolio\Unreal\Project\UE_PUBG\Source\UE_PUBG\Item\C_Item.cpp", "C++", 178, 0, 28, 50, 256
"c:\Users\wadan\Desktop\SGA\Portfolio\Unreal\Project\UE_PUBG\Source\UE_PUBG\Item\C_Item.h", "C++", 162, 0, 76, 61, 299
"c:\Users\wadan\Desktop\SGA\Portfolio\Unreal\Project\UE_PUBG\Source\UE_PUBG\Item\ConsumableItem\Boosting\C_EnergyDrink.cpp", "C++", 41, 0, 1, 18, 60
"c:\Users\wadan\Desktop\SGA\Portfolio\Unreal\Project\UE_PUBG\Source\UE_PUBG\Item\ConsumableItem\Boosting\C_EnergyDrink.h", "C++", 19, 0, 7, 13, 39
"c:\Users\wadan\Desktop\SGA\Portfolio\Unreal\Project\UE_PUBG\Source\UE_PUBG\Item\ConsumableItem\Boosting\C_PainKiller.cpp", "C++", 41, 0, 1, 19, 61
"c:\Users\wadan\Desktop\SGA\Portfolio\Unreal\Project\UE_PUBG\Source\UE_PUBG\Item\ConsumableItem\Boosting\C_PainKiller.h", "C++", 19, 0, 7, 13, 39
"c:\Users\wadan\Desktop\SGA\Portfolio\Unreal\Project\UE_PUBG\Source\UE_PUBG\Item\ConsumableItem\C_BoostItem.cpp", "C++", 38, 0, 1, 16, 55
"c:\Users\wadan\Desktop\SGA\Portfolio\Unreal\Project\UE_PUBG\Source\UE_PUBG\Item\ConsumableItem\C_BoostItem.h", "C++", 22, 0, 4, 18, 44
"c:\Users\wadan\Desktop\SGA\Portfolio\Unreal\Project\UE_PUBG\Source\UE_PUBG\Item\ConsumableItem\C_ConsumableItem.cpp", "C++", 307, 0, 57, 116, 480
"c:\Users\wadan\Desktop\SGA\Portfolio\Unreal\Project\UE_PUBG\Source\UE_PUBG\Item\ConsumableItem\C_ConsumableItem.h", "C++", 67, 0, 40, 55, 162
"c:\Users\wadan\Desktop\SGA\Portfolio\Unreal\Project\UE_PUBG\Source\UE_PUBG\Item\ConsumableItem\C_HealItem.cpp", "C++", 42, 0, 2, 15, 59
"c:\Users\wadan\Desktop\SGA\Portfolio\Unreal\Project\UE_PUBG\Source\UE_PUBG\Item\ConsumableItem\C_HealItem.h", "C++", 24, 0, 5, 18, 47
"c:\Users\wadan\Desktop\SGA\Portfolio\Unreal\Project\UE_PUBG\Source\UE_PUBG\Item\ConsumableItem\Healing\C_Bandage.cpp", "C++", 67, 0, 3, 23, 93
"c:\Users\wadan\Desktop\SGA\Portfolio\Unreal\Project\UE_PUBG\Source\UE_PUBG\Item\ConsumableItem\Healing\C_Bandage.h", "C++", 28, 0, 8, 20, 56
"c:\Users\wadan\Desktop\SGA\Portfolio\Unreal\Project\UE_PUBG\Source\UE_PUBG\Item\ConsumableItem\Healing\C_FirstAidKit.cpp", "C++", 55, 0, 2, 23, 80
"c:\Users\wadan\Desktop\SGA\Portfolio\Unreal\Project\UE_PUBG\Source\UE_PUBG\Item\ConsumableItem\Healing\C_FirstAidKit.h", "C++", 21, 0, 7, 14, 42
"c:\Users\wadan\Desktop\SGA\Portfolio\Unreal\Project\UE_PUBG\Source\UE_PUBG\Item\ConsumableItem\Healing\C_MedKit.cpp", "C++", 73, 0, 6, 27, 106
"c:\Users\wadan\Desktop\SGA\Portfolio\Unreal\Project\UE_PUBG\Source\UE_PUBG\Item\ConsumableItem\Healing\C_MedKit.h", "C++", 28, 0, 7, 18, 53
"c:\Users\wadan\Desktop\SGA\Portfolio\Unreal\Project\UE_PUBG\Source\UE_PUBG\Item\Equipment\C_BackPack.cpp", "C++", 146, 0, 78, 71, 295
"c:\Users\wadan\Desktop\SGA\Portfolio\Unreal\Project\UE_PUBG\Source\UE_PUBG\Item\Equipment\C_BackPack.h", "C++", 27, 0, 23, 25, 75
"c:\Users\wadan\Desktop\SGA\Portfolio\Unreal\Project\UE_PUBG\Source\UE_PUBG\Item\Equipment\C_EquipableItem.cpp", "C++", 61, 0, 6, 21, 88
"c:\Users\wadan\Desktop\SGA\Portfolio\Unreal\Project\UE_PUBG\Source\UE_PUBG\Item\Equipment\C_EquipableItem.h", "C++", 42, 0, 19, 31, 92
"c:\Users\wadan\Desktop\SGA\Portfolio\Unreal\Project\UE_PUBG\Source\UE_PUBG\Item\Equipment\C_Helmet.cpp", "C++", 97, 0, 15, 36, 148
"c:\Users\wadan\Desktop\SGA\Portfolio\Unreal\Project\UE_PUBG\Source\UE_PUBG\Item\Equipment\C_Helmet.h", "C++", 26, 0, 5, 23, 54
"c:\Users\wadan\Desktop\SGA\Portfolio\Unreal\Project\UE_PUBG\Source\UE_PUBG\Item\Equipment\C_Vest.cpp", "C++", 87, 0, 15, 31, 133
"c:\Users\wadan\Desktop\SGA\Portfolio\Unreal\Project\UE_PUBG\Source\UE_PUBG\Item\Equipment\C_Vest.h", "C++", 21, 0, 4, 17, 42
"c:\Users\wadan\Desktop\SGA\Portfolio\Unreal\Project\UE_PUBG\Source\UE_PUBG\Item\ItemBullet\C_Item_Bullet.cpp", "C++", 146, 0, 10, 51, 207
"c:\Users\wadan\Desktop\SGA\Portfolio\Unreal\Project\UE_PUBG\Source\UE_PUBG\Item\ItemBullet\C_Item_Bullet.h", "C++", 31, 0, 13, 13, 57
"c:\Users\wadan\Desktop\SGA\Portfolio\Unreal\Project\UE_PUBG\Source\UE_PUBG\Item\Weapon\C_Weapon.cpp", "C++", 247, 0, 20, 73, 340
"c:\Users\wadan\Desktop\SGA\Portfolio\Unreal\Project\UE_PUBG\Source\UE_PUBG\Item\Weapon\C_Weapon.h", "C++", 64, 0, 68, 47, 179
"c:\Users\wadan\Desktop\SGA\Portfolio\Unreal\Project\UE_PUBG\Source\UE_PUBG\Item\Weapon\Gun\C_AR.cpp", "C++", 67, 0, 2, 20, 89
"c:\Users\wadan\Desktop\SGA\Portfolio\Unreal\Project\UE_PUBG\Source\UE_PUBG\Item\Weapon\Gun\C_AR.h", "C++", 21, 0, 7, 13, 41
"c:\Users\wadan\Desktop\SGA\Portfolio\Unreal\Project\UE_PUBG\Source\UE_PUBG\Item\Weapon\Gun\C_Bullet.cpp", "C++", 163, 0, 35, 63, 261
"c:\Users\wadan\Desktop\SGA\Portfolio\Unreal\Project\UE_PUBG\Source\UE_PUBG\Item\Weapon\Gun\C_Bullet.h", "C++", 61, 0, 17, 26, 104
"c:\Users\wadan\Desktop\SGA\Portfolio\Unreal\Project\UE_PUBG\Source\UE_PUBG\Item\Weapon\Gun\C_Gun.cpp", "C++", 862, 0, 158, 210, 1230
"c:\Users\wadan\Desktop\SGA\Portfolio\Unreal\Project\UE_PUBG\Source\UE_PUBG\Item\Weapon\Gun\C_Gun.h", "C++", 228, 0, 53, 81, 362
"c:\Users\wadan\Desktop\SGA\Portfolio\Unreal\Project\UE_PUBG\Source\UE_PUBG\Item\Weapon\Gun\C_SR.cpp", "C++", 114, 0, 12, 29, 155
"c:\Users\wadan\Desktop\SGA\Portfolio\Unreal\Project\UE_PUBG\Source\UE_PUBG\Item\Weapon\Gun\C_SR.h", "C++", 35, 0, 8, 12, 55
"c:\Users\wadan\Desktop\SGA\Portfolio\Unreal\Project\UE_PUBG\Source\UE_PUBG\Item\Weapon\MeleeWeapon\C_MeleeWeapon.cpp", "C++", 196, 0, 18, 55, 269
"c:\Users\wadan\Desktop\SGA\Portfolio\Unreal\Project\UE_PUBG\Source\UE_PUBG\Item\Weapon\MeleeWeapon\C_MeleeWeapon.h", "C++", 59, 0, 41, 39, 139
"c:\Users\wadan\Desktop\SGA\Portfolio\Unreal\Project\UE_PUBG\Source\UE_PUBG\Item\Weapon\ThrowingWeapon\AIThrowableAttackStrategy\C_AIFlashBangAttackStrategy.cpp", "C++", 6, 0, 1, 6, 13
"c:\Users\wadan\Desktop\SGA\Portfolio\Unreal\Project\UE_PUBG\Source\UE_PUBG\Item\Weapon\ThrowingWeapon\AIThrowableAttackStrategy\C_AIFlashBangAttackStrategy.h", "C++", 10, 0, 4, 5, 19
"c:\Users\wadan\Desktop\SGA\Portfolio\Unreal\Project\UE_PUBG\Source\UE_PUBG\Item\Weapon\ThrowingWeapon\AIThrowableAttackStrategy\C_AIGrenadeAttackStrategy.cpp", "C++", 2, 0, 1, 5, 8
"c:\Users\wadan\Desktop\SGA\Portfolio\Unreal\Project\UE_PUBG\Source\UE_PUBG\Item\Weapon\ThrowingWeapon\AIThrowableAttackStrategy\C_AIGrenadeAttackStrategy.h", "C++", 11, 0, 4, 6, 21
"c:\Users\wadan\Desktop\SGA\Portfolio\Unreal\Project\UE_PUBG\Source\UE_PUBG\Item\Weapon\ThrowingWeapon\AIThrowableAttackStrategy\C_AISmokeGrenadeAttackStrategy.cpp", "C++", 22, 0, 4, 12, 38
"c:\Users\wadan\Desktop\SGA\Portfolio\Unreal\Project\UE_PUBG\Source\UE_PUBG\Item\Weapon\ThrowingWeapon\AIThrowableAttackStrategy\C_AISmokeGrenadeAttackStrategy.h", "C++", 16, 0, 5, 10, 31
"c:\Users\wadan\Desktop\SGA\Portfolio\Unreal\Project\UE_PUBG\Source\UE_PUBG\Item\Weapon\ThrowingWeapon\AIThrowableAttackStrategy\C_AIThrowingStrategy.cpp", "C++", 76, 0, 12, 24, 112
"c:\Users\wadan\Desktop\SGA\Portfolio\Unreal\Project\UE_PUBG\Source\UE_PUBG\Item\Weapon\ThrowingWeapon\AIThrowableAttackStrategy\C_AIThrowingStrategy.h", "C++", 20, 0, 21, 11, 52
"c:\Users\wadan\Desktop\SGA\Portfolio\Unreal\Project\UE_PUBG\Source\UE_PUBG\Item\Weapon\ThrowingWeapon\AIThrowableAttackStrategy\I_AIThrowableAttackStrategy.cpp", "C++", 1, 0, 2, 4, 7
"c:\Users\wadan\Desktop\SGA\Portfolio\Unreal\Project\UE_PUBG\Source\UE_PUBG\Item\Weapon\ThrowingWeapon\AIThrowableAttackStrategy\I_AIThrowableAttackStrategy.h", "C++", 16, 0, 18, 9, 43
"c:\Users\wadan\Desktop\SGA\Portfolio\Unreal\Project\UE_PUBG\Source\UE_PUBG\Item\Weapon\ThrowingWeapon\C_FlashBangExplode.cpp", "C++", 99, 0, 22, 50, 171
"c:\Users\wadan\Desktop\SGA\Portfolio\Unreal\Project\UE_PUBG\Source\UE_PUBG\Item\Weapon\ThrowingWeapon\C_FlashBangExplode.h", "C++", 21, 0, 21, 22, 64
"c:\Users\wadan\Desktop\SGA\Portfolio\Unreal\Project\UE_PUBG\Source\UE_PUBG\Item\Weapon\ThrowingWeapon\C_GrenadeExplode.cpp", "C++", 160, 0, 35, 74, 269
"c:\Users\wadan\Desktop\SGA\Portfolio\Unreal\Project\UE_PUBG\Source\UE_PUBG\Item\Weapon\ThrowingWeapon\C_GrenadeExplode.h", "C++", 24, 0, 29, 23, 76
"c:\Users\wadan\Desktop\SGA\Portfolio\Unreal\Project\UE_PUBG\Source\UE_PUBG\Item\Weapon\ThrowingWeapon\C_ScreenShotWidget.cpp", "C++", 17, 0, 13, 14, 44
"c:\Users\wadan\Desktop\SGA\Portfolio\Unreal\Project\UE_PUBG\Source\UE_PUBG\Item\Weapon\ThrowingWeapon\C_ScreenShotWidget.h", "C++", 17, 0, 4, 14, 35
"c:\Users\wadan\Desktop\SGA\Portfolio\Unreal\Project\UE_PUBG\Source\UE_PUBG\Item\Weapon\ThrowingWeapon\C_SmokeGrndExplode.cpp", "C++", 14, 0, 1, 10, 25
"c:\Users\wadan\Desktop\SGA\Portfolio\Unreal\Project\UE_PUBG\Source\UE_PUBG\Item\Weapon\ThrowingWeapon\C_SmokeGrndExplode.h", "C++", 12, 0, 1, 10, 23
"c:\Users\wadan\Desktop\SGA\Portfolio\Unreal\Project\UE_PUBG\Source\UE_PUBG\Item\Weapon\ThrowingWeapon\C_ThrowingWeapon.cpp", "C++", 838, 0, 146, 289, 1273
"c:\Users\wadan\Desktop\SGA\Portfolio\Unreal\Project\UE_PUBG\Source\UE_PUBG\Item\Weapon\ThrowingWeapon\C_ThrowingWeapon.h", "C++", 169, 0, 82, 114, 365
"c:\Users\wadan\Desktop\SGA\Portfolio\Unreal\Project\UE_PUBG\Source\UE_PUBG\Item\Weapon\ThrowingWeapon\I_ExplodeStrategy.cpp", "C++", 1, 0, 2, 6, 9
"c:\Users\wadan\Desktop\SGA\Portfolio\Unreal\Project\UE_PUBG\Source\UE_PUBG\Item\Weapon\ThrowingWeapon\I_ExplodeStrategy.h", "C++", 15, 0, 10, 9, 34
"c:\Users\wadan\Desktop\SGA\Portfolio\Unreal\Project\UE_PUBG\Source\UE_PUBG\Item\Weapon\WeaponStrategy\C_GunStrategy.cpp", "C++", 169, 0, 20, 53, 242
"c:\Users\wadan\Desktop\SGA\Portfolio\Unreal\Project\UE_PUBG\Source\UE_PUBG\Item\Weapon\WeaponStrategy\C_GunStrategy.h", "C++", 24, 0, 4, 13, 41
"c:\Users\wadan\Desktop\SGA\Portfolio\Unreal\Project\UE_PUBG\Source\UE_PUBG\Item\Weapon\WeaponStrategy\C_MeleeWeaponStrategy.cpp", "C++", 44, 0, 1, 20, 65
"c:\Users\wadan\Desktop\SGA\Portfolio\Unreal\Project\UE_PUBG\Source\UE_PUBG\Item\Weapon\WeaponStrategy\C_MeleeWeaponStrategy.h", "C++", 19, 0, 4, 13, 36
"c:\Users\wadan\Desktop\SGA\Portfolio\Unreal\Project\UE_PUBG\Source\UE_PUBG\Item\Weapon\WeaponStrategy\C_ThrowingWeaponStrategy.cpp", "C++", 56, 0, 2, 26, 84
"c:\Users\wadan\Desktop\SGA\Portfolio\Unreal\Project\UE_PUBG\Source\UE_PUBG\Item\Weapon\WeaponStrategy\C_ThrowingWeaponStrategy.h", "C++", 19, 0, 5, 13, 37
"c:\Users\wadan\Desktop\SGA\Portfolio\Unreal\Project\UE_PUBG\Source\UE_PUBG\Item\Weapon\WeaponStrategy\I_WeaponButtonStrategy.cpp", "C++", 1, 0, 2, 6, 9
"c:\Users\wadan\Desktop\SGA\Portfolio\Unreal\Project\UE_PUBG\Source\UE_PUBG\Item\Weapon\WeaponStrategy\I_WeaponButtonStrategy.h", "C++", 22, 0, 54, 19, 95
"c:\Users\wadan\Desktop\SGA\Portfolio\Unreal\Project\UE_PUBG\Source\UE_PUBG\MagneticField\C_MagneticFieldManager.cpp", "C++", 142, 0, 21, 66, 229
"c:\Users\wadan\Desktop\SGA\Portfolio\Unreal\Project\UE_PUBG\Source\UE_PUBG\MagneticField\C_MagneticFieldManager.h", "C++", 84, 0, 48, 50, 182
"c:\Users\wadan\Desktop\SGA\Portfolio\Unreal\Project\UE_PUBG\Source\UE_PUBG\MagneticField\C_MagneticWall.cpp", "C++", 26, 0, 6, 15, 47
"c:\Users\wadan\Desktop\SGA\Portfolio\Unreal\Project\UE_PUBG\Source\UE_PUBG\MagneticField\C_MagneticWall.h", "C++", 19, 0, 4, 14, 37
"c:\Users\wadan\Desktop\SGA\Portfolio\Unreal\Project\UE_PUBG\Source\UE_PUBG\MyWaterBody.cpp", "C++", 1, 0, 1, 6, 8
"c:\Users\wadan\Desktop\SGA\Portfolio\Unreal\Project\UE_PUBG\Source\UE_PUBG\MyWaterBody.h", "C++", 9, 0, 4, 7, 20
"c:\Users\wadan\Desktop\SGA\Portfolio\Unreal\Project\UE_PUBG\Source\UE_PUBG\Singleton\C_GameSceneManager.cpp", "C++", 76, 0, 15, 27, 118
"c:\Users\wadan\Desktop\SGA\Portfolio\Unreal\Project\UE_PUBG\Source\UE_PUBG\Singleton\C_GameSceneManager.h", "C++", 46, 0, 15, 34, 95
"c:\Users\wadan\Desktop\SGA\Portfolio\Unreal\Project\UE_PUBG\Source\UE_PUBG\UE_PUBG.Build.cs", "C#", 0, 26, 17, 9, 52
"c:\Users\wadan\Desktop\SGA\Portfolio\Unreal\Project\UE_PUBG\Source\UE_PUBG\UE_PUBG.cpp", "C++", 3, 0, 1, 5, 9
"c:\Users\wadan\Desktop\SGA\Portfolio\Unreal\Project\UE_PUBG\Source\UE_PUBG\UE_PUBG.h", "C++", 2, 0, 1, 5, 8
"c:\Users\wadan\Desktop\SGA\Portfolio\Unreal\Project\UE_PUBG\Source\UE_PUBG\UE_PUBGCharacter.cpp", "C++", 79, 0, 27, 26, 132
"c:\Users\wadan\Desktop\SGA\Portfolio\Unreal\Project\UE_PUBG\Source\UE_PUBG\UE_PUBGCharacter.h", "C++", 39, 0, 13, 24, 76
"c:\Users\wadan\Desktop\SGA\Portfolio\Unreal\Project\UE_PUBG\Source\UE_PUBG\UE_PUBGGameMode.cpp", "C++", 27, 0, 6, 10, 43
"c:\Users\wadan\Desktop\SGA\Portfolio\Unreal\Project\UE_PUBG\Source\UE_PUBG\UE_PUBGGameMode.h", "C++", 11, 0, 1, 10, 22
"c:\Users\wadan\Desktop\SGA\Portfolio\Unreal\Project\UE_PUBG\Source\UE_PUBG\Utility\C_TimelineComponent.cpp", "C++", 0, 0, 0, 1, 1
"c:\Users\wadan\Desktop\SGA\Portfolio\Unreal\Project\UE_PUBG\Source\UE_PUBG\Utility\C_TimelineUtility.cpp", "C++", 109, 0, 16, 27, 152
"c:\Users\wadan\Desktop\SGA\Portfolio\Unreal\Project\UE_PUBG\Source\UE_PUBG\Utility\C_TimelineUtility.h", "C++", 59, 0, 9, 22, 90
"c:\Users\wadan\Desktop\SGA\Portfolio\Unreal\Project\UE_PUBG\Source\UE_PUBG\Utility\C_Util.cpp", "C++", 47, 0, 1, 15, 63
"c:\Users\wadan\Desktop\SGA\Portfolio\Unreal\Project\UE_PUBG\Source\UE_PUBG\Utility\C_Util.h", "C++", 21, 0, 4, 10, 35
"Total", "-", 18465, 26, 5284, 7985, 31760