"filename", "language", "C++", "C#", "comment", "blank", "total"
"c:\Users\wadan\Desktop\SGA\Portfolio\Unreal\Project\UE_PUBG\Source\UE_PUBG\AI\C_BehaviorComponent.cpp", "C++", 35, 0, 1, 17, 53
"c:\Users\wadan\Desktop\SGA\Portfolio\Unreal\Project\UE_PUBG\Source\UE_PUBG\AI\C_BehaviorComponent.h", "C++", 50, 0, 2, 21, 73
"c:\Users\wadan\Desktop\SGA\Portfolio\Unreal\Project\UE_PUBG\Source\UE_PUBG\AI\C_EnemyAIController.cpp", "C++", 83, 0, 4, 28, 115
"c:\Users\wadan\Desktop\SGA\Portfolio\Unreal\Project\UE_PUBG\Source\UE_PUBG\AI\C_EnemyAIController.h", "C++", 24, 0, 8, 14, 46
"c:\Users\wadan\Desktop\SGA\Portfolio\Unreal\Project\UE_PUBG\Source\UE_PUBG\AI\Service\C_BTServiceCombat.cpp", "C++", 9, 0, 1, 7, 17
"c:\Users\wadan\Desktop\SGA\Portfolio\Unreal\Project\UE_PUBG\Source\UE_PUBG\AI\Service\C_BTServiceCombat.h", "C++", 12, 0, 4, 8, 24
"c:\Users\wadan\Desktop\SGA\Portfolio\Unreal\Project\UE_PUBG\Source\UE_PUBG\AI\Service\C_BTServiceIdle.cpp", "C++", 28, 0, 2, 16, 46
"c:\Users\wadan\Desktop\SGA\Portfolio\Unreal\Project\UE_PUBG\Source\UE_PUBG\AI\Service\C_BTServiceIdle.h", "C++", 12, 0, 4, 8, 24
"c:\Users\wadan\Desktop\SGA\Portfolio\Unreal\Project\UE_PUBG\Source\UE_PUBG\AI\Service\C_BTServiceStateMachine.cpp", "C++", 14, 0, 3, 10, 27
"c:\Users\wadan\Desktop\SGA\Portfolio\Unreal\Project\UE_PUBG\Source\UE_PUBG\AI\Service\C_BTServiceStateMachine.h", "C++", 15, 0, 4, 10, 29
"c:\Users\wadan\Desktop\SGA\Portfolio\Unreal\Project\UE_PUBG\Source\UE_PUBG\AI\Task\CombatTask\C_BTTaskSwapWeapon.cpp", "C++", 50, 0, 15, 20, 85
"c:\Users\wadan\Desktop\SGA\Portfolio\Unreal\Project\UE_PUBG\Source\UE_PUBG\AI\Task\CombatTask\C_BTTaskSwapWeapon.h", "C++", 17, 0, 4, 11, 32
"c:\Users\wadan\Desktop\SGA\Portfolio\Unreal\Project\UE_PUBG\Source\UE_PUBG\Airplane\C_Airplane.cpp", "C++", 82, 0, 12, 34, 128
"c:\Users\wadan\Desktop\SGA\Portfolio\Unreal\Project\UE_PUBG\Source\UE_PUBG\Airplane\C_Airplane.h", "C++", 39, 0, 16, 27, 82
"c:\Users\wadan\Desktop\SGA\Portfolio\Unreal\Project\UE_PUBG\Source\UE_PUBG\Airplane\C_AirplaneManager.cpp", "C++", 208, 0, 28, 66, 302
"c:\Users\wadan\Desktop\SGA\Portfolio\Unreal\Project\UE_PUBG\Source\UE_PUBG\Airplane\C_AirplaneManager.h", "C++", 48, 0, 34, 37, 119
"c:\Users\wadan\Desktop\SGA\Portfolio\Unreal\Project\UE_PUBG\Source\UE_PUBG\C_MyMotionWarpingComponent.cpp", "C++", 1, 0, 1, 4, 6
"c:\Users\wadan\Desktop\SGA\Portfolio\Unreal\Project\UE_PUBG\Source\UE_PUBG\C_MyMotionWarpingComponent.h", "C++", 9, 0, 4, 6, 19
"c:\Users\wadan\Desktop\SGA\Portfolio\Unreal\Project\UE_PUBG\Source\UE_PUBG\Character\C_AnimBasicCharacter.cpp", "C++", 200, 0, 50, 57, 307
"c:\Users\wadan\Desktop\SGA\Portfolio\Unreal\Project\UE_PUBG\Source\UE_PUBG\Character\C_AnimBasicCharacter.h", "C++", 105, 0, 8, 49, 162
"c:\Users\wadan\Desktop\SGA\Portfolio\Unreal\Project\UE_PUBG\Source\UE_PUBG\Character\C_AnimEnemy.cpp", "C++", 7, 0, 1, 6, 14
"c:\Users\wadan\Desktop\SGA\Portfolio\Unreal\Project\UE_PUBG\Source\UE_PUBG\Character\C_AnimEnemy.h", "C++", 11, 0, 7, 7, 25
"c:\Users\wadan\Desktop\SGA\Portfolio\Unreal\Project\UE_PUBG\Source\UE_PUBG\Character\C_AnimPlayer.cpp", "C++", 41, 0, 1, 16, 58
"c:\Users\wadan\Desktop\SGA\Portfolio\Unreal\Project\UE_PUBG\Source\UE_PUBG\Character\C_AnimPlayer.h", "C++", 14, 0, 4, 10, 28
"c:\Users\wadan\Desktop\SGA\Portfolio\Unreal\Project\UE_PUBG\Source\UE_PUBG\Character\C_BasicCharacter.cpp", "C++", 226, 0, 78, 81, 385
"c:\Users\wadan\Desktop\SGA\Portfolio\Unreal\Project\UE_PUBG\Source\UE_PUBG\Character\C_BasicCharacter.h", "C++", 253, 0, 74, 118, 445
"c:\Users\wadan\Desktop\SGA\Portfolio\Unreal\Project\UE_PUBG\Source\UE_PUBG\Character\C_Enemy.cpp", "C++", 37, 0, 7, 17, 61
"c:\Users\wadan\Desktop\SGA\Portfolio\Unreal\Project\UE_PUBG\Source\UE_PUBG\Character\C_Enemy.h", "C++", 18, 0, 7, 12, 37
"c:\Users\wadan\Desktop\SGA\Portfolio\Unreal\Project\UE_PUBG\Source\UE_PUBG\Character\C_Player.cpp", "C++", 691, 0, 218, 218, 1127
"c:\Users\wadan\Desktop\SGA\Portfolio\Unreal\Project\UE_PUBG\Source\UE_PUBG\Character\C_Player.h", "C++", 154, 0, 73, 88, 315
"c:\Users\wadan\Desktop\SGA\Portfolio\Unreal\Project\UE_PUBG\Source\UE_PUBG\Character\C_WorldPingActor.cpp", "C++", 54, 0, 3, 27, 84
"c:\Users\wadan\Desktop\SGA\Portfolio\Unreal\Project\UE_PUBG\Source\UE_PUBG\Character\C_WorldPingActor.h", "C++", 25, 0, 3, 18, 46
"c:\Users\wadan\Desktop\SGA\Portfolio\Unreal\Project\UE_PUBG\Source\UE_PUBG\Character\Component\C_AttachableItemMeshComponent.cpp", "C++", 157, 0, 34, 46, 237
"c:\Users\wadan\Desktop\SGA\Portfolio\Unreal\Project\UE_PUBG\Source\UE_PUBG\Character\Component\C_AttachableItemMeshComponent.h", "C++", 26, 0, 4, 10, 40
"c:\Users\wadan\Desktop\SGA\Portfolio\Unreal\Project\UE_PUBG\Source\UE_PUBG\Character\Component\C_CameraEffectComponent.cpp", "C++", 146, 0, 24, 58, 228
"c:\Users\wadan\Desktop\SGA\Portfolio\Unreal\Project\UE_PUBG\Source\UE_PUBG\Character\Component\C_CameraEffectComponent.h", "C++", 60, 0, 29, 37, 126
"c:\Users\wadan\Desktop\SGA\Portfolio\Unreal\Project\UE_PUBG\Source\UE_PUBG\Character\Component\C_ConsumableUsageMeshComponent.cpp", "C++", 60, 0, 10, 21, 91
"c:\Users\wadan\Desktop\SGA\Portfolio\Unreal\Project\UE_PUBG\Source\UE_PUBG\Character\Component\C_ConsumableUsageMeshComponent.h", "C++", 36, 0, 10, 21, 67
"c:\Users\wadan\Desktop\SGA\Portfolio\Unreal\Project\UE_PUBG\Source\UE_PUBG\Character\Component\C_CrosshairWidgetComponent.cpp", "C++", 192, 0, 13, 36, 241
"c:\Users\wadan\Desktop\SGA\Portfolio\Unreal\Project\UE_PUBG\Source\UE_PUBG\Character\Component\C_CrosshairWidgetComponent.h", "C++", 64, 0, 8, 10, 82
"c:\Users\wadan\Desktop\SGA\Portfolio\Unreal\Project\UE_PUBG\Source\UE_PUBG\Character\Component\C_EquippedComponent.cpp", "C++", 239, 0, 70, 87, 396
"c:\Users\wadan\Desktop\SGA\Portfolio\Unreal\Project\UE_PUBG\Source\UE_PUBG\Character\Component\C_EquippedComponent.h", "C++", 78, 0, 50, 47, 175
"c:\Users\wadan\Desktop\SGA\Portfolio\Unreal\Project\UE_PUBG\Source\UE_PUBG\Character\Component\C_InputComponent.cpp", "C++", 450, 0, 90, 145, 685
"c:\Users\wadan\Desktop\SGA\Portfolio\Unreal\Project\UE_PUBG\Source\UE_PUBG\Character\Component\C_InputComponent.h", "C++", 105, 0, 19, 56, 180
"c:\Users\wadan\Desktop\SGA\Portfolio\Unreal\Project\UE_PUBG\Source\UE_PUBG\Character\Component\C_InvenComponent.cpp", "C++", 320, 0, 105, 88, 513
"c:\Users\wadan\Desktop\SGA\Portfolio\Unreal\Project\UE_PUBG\Source\UE_PUBG\Character\Component\C_InvenComponent.h", "C++", 112, 0, 54, 63, 229
"c:\Users\wadan\Desktop\SGA\Portfolio\Unreal\Project\UE_PUBG\Source\UE_PUBG\Character\Component\C_InvenSystem.cpp", "C++", 86, 0, 28, 33, 147
"c:\Users\wadan\Desktop\SGA\Portfolio\Unreal\Project\UE_PUBG\Source\UE_PUBG\Character\Component\C_InvenSystem.h", "C++", 37, 0, 20, 20, 77
"c:\Users\wadan\Desktop\SGA\Portfolio\Unreal\Project\UE_PUBG\Source\UE_PUBG\Character\Component\C_ParkourComponent.cpp", "C++", 493, 0, 90, 157, 740
"c:\Users\wadan\Desktop\SGA\Portfolio\Unreal\Project\UE_PUBG\Source\UE_PUBG\Character\Component\C_ParkourComponent.h", "C++", 106, 0, 77, 71, 254
"c:\Users\wadan\Desktop\SGA\Portfolio\Unreal\Project\UE_PUBG\Source\UE_PUBG\Character\Component\C_PingSystemComponent.cpp", "C++", 48, 0, 3, 23, 74
"c:\Users\wadan\Desktop\SGA\Portfolio\Unreal\Project\UE_PUBG\Source\UE_PUBG\Character\Component\C_PingSystemComponent.h", "C++", 28, 0, 10, 25, 63
"c:\Users\wadan\Desktop\SGA\Portfolio\Unreal\Project\UE_PUBG\Source\UE_PUBG\Character\Component\C_PlayerController.cpp", "C++", 14, 0, 41, 6, 61
"c:\Users\wadan\Desktop\SGA\Portfolio\Unreal\Project\UE_PUBG\Source\UE_PUBG\Character\Component\C_PlayerController.h", "C++", 11, 0, 9, 6, 26
"c:\Users\wadan\Desktop\SGA\Portfolio\Unreal\Project\UE_PUBG\Source\UE_PUBG\Character\Component\C_PoseColliderHandlerComponent.cpp", "C++", 246, 0, 49, 92, 387
"c:\Users\wadan\Desktop\SGA\Portfolio\Unreal\Project\UE_PUBG\Source\UE_PUBG\Character\Component\C_PoseColliderHandlerComponent.h", "C++", 59, 0, 66, 49, 174
"c:\Users\wadan\Desktop\SGA\Portfolio\Unreal\Project\UE_PUBG\Source\UE_PUBG\Character\Component\C_SkyDivingComponent.cpp", "C++", 284, 0, 58, 97, 439
"c:\Users\wadan\Desktop\SGA\Portfolio\Unreal\Project\UE_PUBG\Source\UE_PUBG\Character\Component\C_SkyDivingComponent.h", "C++", 109, 0, 40, 58, 207
"c:\Users\wadan\Desktop\SGA\Portfolio\Unreal\Project\UE_PUBG\Source\UE_PUBG\Character\Component\C_StatComponent.cpp", "C++", 149, 0, 12, 59, 220
"c:\Users\wadan\Desktop\SGA\Portfolio\Unreal\Project\UE_PUBG\Source\UE_PUBG\Character\Component\C_StatComponent.h", "C++", 86, 0, 38, 47, 171
"c:\Users\wadan\Desktop\SGA\Portfolio\Unreal\Project\UE_PUBG\Source\UE_PUBG\Character\Component\C_SwimmingComponent.cpp", "C++", 247, 0, 52, 92, 391
"c:\Users\wadan\Desktop\SGA\Portfolio\Unreal\Project\UE_PUBG\Source\UE_PUBG\Character\Component\C_SwimmingComponent.h", "C++", 72, 0, 24, 40, 136
"c:\Users\wadan\Desktop\SGA\Portfolio\Unreal\Project\UE_PUBG\Source\UE_PUBG\Character\Component\ParkourActionStrategy\C_MantleHighActionStrategy.cpp", "C++", 41, 0, 5, 27, 73
"c:\Users\wadan\Desktop\SGA\Portfolio\Unreal\Project\UE_PUBG\Source\UE_PUBG\Character\Component\ParkourActionStrategy\C_MantleHighActionStrategy.h", "C++", 12, 0, 4, 7, 23
"c:\Users\wadan\Desktop\SGA\Portfolio\Unreal\Project\UE_PUBG\Source\UE_PUBG\Character\Component\ParkourActionStrategy\C_MantleLowActionStrategy.cpp", "C++", 26, 0, 3, 18, 47
"c:\Users\wadan\Desktop\SGA\Portfolio\Unreal\Project\UE_PUBG\Source\UE_PUBG\Character\Component\ParkourActionStrategy\C_MantleLowActionStrategy.h", "C++", 12, 0, 4, 7, 23
"c:\Users\wadan\Desktop\SGA\Portfolio\Unreal\Project\UE_PUBG\Source\UE_PUBG\Character\Component\ParkourActionStrategy\C_VaultHighActionStrategy.cpp", "C++", 43, 0, 6, 28, 77
"c:\Users\wadan\Desktop\SGA\Portfolio\Unreal\Project\UE_PUBG\Source\UE_PUBG\Character\Component\ParkourActionStrategy\C_VaultHighActionStrategy.h", "C++", 12, 0, 4, 6, 22
"c:\Users\wadan\Desktop\SGA\Portfolio\Unreal\Project\UE_PUBG\Source\UE_PUBG\Character\Component\ParkourActionStrategy\C_VaultLowActionStrategy.cpp", "C++", 45, 0, 7, 26, 78
"c:\Users\wadan\Desktop\SGA\Portfolio\Unreal\Project\UE_PUBG\Source\UE_PUBG\Character\Component\ParkourActionStrategy\C_VaultLowActionStrategy.h", "C++", 12, 0, 4, 7, 23
"c:\Users\wadan\Desktop\SGA\Portfolio\Unreal\Project\UE_PUBG\Source\UE_PUBG\Character\Component\ParkourActionStrategy\I_ParkourActionStrategy.cpp", "C++", 1, 0, 2, 4, 7
"c:\Users\wadan\Desktop\SGA\Portfolio\Unreal\Project\UE_PUBG\Source\UE_PUBG\Character\Component\ParkourActionStrategy\I_ParkourActionStrategy.h", "C++", 15, 0, 10, 9, 34
"c:\Users\wadan\Desktop\SGA\Portfolio\Unreal\Project\UE_PUBG\Source\UE_PUBG\HUD\C_HUDWidget.cpp", "C++", 12, 0, 1, 9, 22
"c:\Users\wadan\Desktop\SGA\Portfolio\Unreal\Project\UE_PUBG\Source\UE_PUBG\HUD\C_HUDWidget.h", "C++", 76, 0, 36, 50, 162
"c:\Users\wadan\Desktop\SGA\Portfolio\Unreal\Project\UE_PUBG\Source\UE_PUBG\HUD\C_InstructionWidget.cpp", "C++", 30, 0, 3, 16, 49
"c:\Users\wadan\Desktop\SGA\Portfolio\Unreal\Project\UE_PUBG\Source\UE_PUBG\HUD\C_InstructionWidget.h", "C++", 26, 0, 4, 16, 46
"c:\Users\wadan\Desktop\SGA\Portfolio\Unreal\Project\UE_PUBG\Source\UE_PUBG\HUD\C_MainMapWidget.cpp", "C++", 286, 0, 59, 106, 451
"c:\Users\wadan\Desktop\SGA\Portfolio\Unreal\Project\UE_PUBG\Source\UE_PUBG\HUD\C_MainMapWidget.h", "C++", 60, 0, 43, 43, 146
"c:\Users\wadan\Desktop\SGA\Portfolio\Unreal\Project\UE_PUBG\Source\UE_PUBG\HUD\C_MapWidget.cpp", "C++", 105, 0, 20, 41, 166
"c:\Users\wadan\Desktop\SGA\Portfolio\Unreal\Project\UE_PUBG\Source\UE_PUBG\HUD\C_MapWidget.h", "C++", 64, 0, 63, 49, 176
"c:\Users\wadan\Desktop\SGA\Portfolio\Unreal\Project\UE_PUBG\Source\UE_PUBG\HUD\C_OxygenWidget.cpp", "C++", 1, 0, 1, 4, 6
"c:\Users\wadan\Desktop\SGA\Portfolio\Unreal\Project\UE_PUBG\Source\UE_PUBG\HUD\C_OxygenWidget.h", "C++", 12, 0, 7, 8, 27
"c:\Users\wadan\Desktop\SGA\Portfolio\Unreal\Project\UE_PUBG\Source\UE_PUBG\HUD\C_SkyDiveWidget.cpp", "C++", 79, 0, 10, 34, 123
"c:\Users\wadan\Desktop\SGA\Portfolio\Unreal\Project\UE_PUBG\Source\UE_PUBG\HUD\C_SkyDiveWidget.h", "C++", 48, 0, 12, 31, 91
"c:\Users\wadan\Desktop\SGA\Portfolio\Unreal\Project\UE_PUBG\Source\UE_PUBG\InvenUI\BasicItemSlot\C_BasicEquippedItemSlotWidget.cpp", "C++", 1, 0, 1, 4, 6
"c:\Users\wadan\Desktop\SGA\Portfolio\Unreal\Project\UE_PUBG\Source\UE_PUBG\InvenUI\BasicItemSlot\C_BasicEquippedItemSlotWidget.h", "C++", 9, 0, 4, 5, 18
"c:\Users\wadan\Desktop\SGA\Portfolio\Unreal\Project\UE_PUBG\Source\UE_PUBG\InvenUI\BasicItemSlot\EquipmentSlot\C_AttachableItemSlotWidget.cpp", "C++", 1, 0, 1, 4, 6
"c:\Users\wadan\Desktop\SGA\Portfolio\Unreal\Project\UE_PUBG\Source\UE_PUBG\InvenUI\BasicItemSlot\EquipmentSlot\C_AttachableItemSlotWidget.h", "C++", 9, 0, 4, 5, 18
"c:\Users\wadan\Desktop\SGA\Portfolio\Unreal\Project\UE_PUBG\Source\UE_PUBG\InvenUI\BasicItemSlot\EquipmentSlot\C_BackPackSlotWidget.cpp", "C++", 1, 0, 1, 4, 6
"c:\Users\wadan\Desktop\SGA\Portfolio\Unreal\Project\UE_PUBG\Source\UE_PUBG\InvenUI\BasicItemSlot\EquipmentSlot\C_BackPackSlotWidget.h", "C++", 9, 0, 4, 5, 18
"c:\Users\wadan\Desktop\SGA\Portfolio\Unreal\Project\UE_PUBG\Source\UE_PUBG\InvenUI\BasicItemSlot\EquipmentSlot\C_EquipmentSlotWidget.cpp", "C++", 1, 0, 1, 4, 6
"c:\Users\wadan\Desktop\SGA\Portfolio\Unreal\Project\UE_PUBG\Source\UE_PUBG\InvenUI\BasicItemSlot\EquipmentSlot\C_EquipmentSlotWidget.h", "C++", 9, 0, 4, 5, 18
"c:\Users\wadan\Desktop\SGA\Portfolio\Unreal\Project\UE_PUBG\Source\UE_PUBG\InvenUI\BasicItemSlot\EquipmentSlot\C_HelmetSlotWidget.cpp", "C++", 1, 0, 1, 4, 6
"c:\Users\wadan\Desktop\SGA\Portfolio\Unreal\Project\UE_PUBG\Source\UE_PUBG\InvenUI\BasicItemSlot\EquipmentSlot\C_HelmetSlotWidget.h", "C++", 9, 0, 4, 5, 18
"c:\Users\wadan\Desktop\SGA\Portfolio\Unreal\Project\UE_PUBG\Source\UE_PUBG\InvenUI\BasicItemSlot\EquipmentSlot\C_VestSlotWidget.cpp", "C++", 1, 0, 1, 4, 6
"c:\Users\wadan\Desktop\SGA\Portfolio\Unreal\Project\UE_PUBG\Source\UE_PUBG\InvenUI\BasicItemSlot\EquipmentSlot\C_VestSlotWidget.h", "C++", 9, 0, 4, 5, 18
"c:\Users\wadan\Desktop\SGA\Portfolio\Unreal\Project\UE_PUBG\Source\UE_PUBG\InvenUI\BasicItemSlot\WeaponSlot\C_MeleeWeaponSlotWidget.cpp", "C++", 1, 0, 1, 4, 6
"c:\Users\wadan\Desktop\SGA\Portfolio\Unreal\Project\UE_PUBG\Source\UE_PUBG\InvenUI\BasicItemSlot\WeaponSlot\C_MeleeWeaponSlotWidget.h", "C++", 9, 0, 4, 5, 18
"c:\Users\wadan\Desktop\SGA\Portfolio\Unreal\Project\UE_PUBG\Source\UE_PUBG\InvenUI\BasicItemSlot\WeaponSlot\C_ThrowableWeaponSlotWidget.cpp", "C++", 1, 0, 1, 4, 6
"c:\Users\wadan\Desktop\SGA\Portfolio\Unreal\Project\UE_PUBG\Source\UE_PUBG\InvenUI\BasicItemSlot\WeaponSlot\C_ThrowableWeaponSlotWidget.h", "C++", 9, 0, 4, 5, 18
"c:\Users\wadan\Desktop\SGA\Portfolio\Unreal\Project\UE_PUBG\Source\UE_PUBG\InvenUI\BasicItemSlot\WeaponSlot\C_WeaponSlotWidget.cpp", "C++", 1, 0, 1, 4, 6
"c:\Users\wadan\Desktop\SGA\Portfolio\Unreal\Project\UE_PUBG\Source\UE_PUBG\InvenUI\BasicItemSlot\WeaponSlot\C_WeaponSlotWidget.h", "C++", 9, 0, 4, 5, 18
"c:\Users\wadan\Desktop\SGA\Portfolio\Unreal\Project\UE_PUBG\Source\UE_PUBG\InvenUI\BasicItemSlot\WeaponSlot\GunSlot\C_GunSlotWidget.cpp", "C++", 1, 0, 1, 4, 6
"c:\Users\wadan\Desktop\SGA\Portfolio\Unreal\Project\UE_PUBG\Source\UE_PUBG\InvenUI\BasicItemSlot\WeaponSlot\GunSlot\C_GunSlotWidget.h", "C++", 9, 0, 4, 5, 18
"c:\Users\wadan\Desktop\SGA\Portfolio\Unreal\Project\UE_PUBG\Source\UE_PUBG\InvenUI\BasicItemSlot\WeaponSlot\GunSlot\C_MainGunSlotWidget.cpp", "C++", 1, 0, 1, 4, 6
"c:\Users\wadan\Desktop\SGA\Portfolio\Unreal\Project\UE_PUBG\Source\UE_PUBG\InvenUI\BasicItemSlot\WeaponSlot\GunSlot\C_MainGunSlotWidget.h", "C++", 9, 0, 4, 5, 18
"c:\Users\wadan\Desktop\SGA\Portfolio\Unreal\Project\UE_PUBG\Source\UE_PUBG\InvenUI\BasicItemSlot\WeaponSlot\GunSlot\C_SubGunSlotWidget.cpp", "C++", 1, 0, 1, 4, 6
"c:\Users\wadan\Desktop\SGA\Portfolio\Unreal\Project\UE_PUBG\Source\UE_PUBG\InvenUI\BasicItemSlot\WeaponSlot\GunSlot\C_SubGunSlotWidget.h", "C++", 9, 0, 4, 5, 18
"c:\Users\wadan\Desktop\SGA\Portfolio\Unreal\Project\UE_PUBG\Source\UE_PUBG\InvenUI\C_CustomUserWidget.cpp", "C++", 1, 0, 1, 4, 6
"c:\Users\wadan\Desktop\SGA\Portfolio\Unreal\Project\UE_PUBG\Source\UE_PUBG\InvenUI\C_CustomUserWidget.h", "C++", 9, 0, 4, 5, 18
"c:\Users\wadan\Desktop\SGA\Portfolio\Unreal\Project\UE_PUBG\Source\UE_PUBG\InvenUI\ItemBar\C_BasicItemBarWidget.cpp", "C++", 1, 0, 1, 4, 6
"c:\Users\wadan\Desktop\SGA\Portfolio\Unreal\Project\UE_PUBG\Source\UE_PUBG\InvenUI\ItemBar\C_BasicItemBarWidget.h", "C++", 9, 0, 4, 5, 18
"c:\Users\wadan\Desktop\SGA\Portfolio\Unreal\Project\UE_PUBG\Source\UE_PUBG\InvenUI\Panel\C_BasicPanelWidget.cpp", "C++", 1, 0, 1, 4, 6
"c:\Users\wadan\Desktop\SGA\Portfolio\Unreal\Project\UE_PUBG\Source\UE_PUBG\InvenUI\Panel\C_BasicPanelWidget.h", "C++", 9, 0, 4, 5, 18
"c:\Users\wadan\Desktop\SGA\Portfolio\Unreal\Project\UE_PUBG\Source\UE_PUBG\InvenUI\Panel\ItemPanel\C_AroundItemPanelWidget.cpp", "C++", 1, 0, 1, 4, 6
"c:\Users\wadan\Desktop\SGA\Portfolio\Unreal\Project\UE_PUBG\Source\UE_PUBG\InvenUI\Panel\ItemPanel\C_AroundItemPanelWidget.h", "C++", 9, 0, 4, 5, 18
"c:\Users\wadan\Desktop\SGA\Portfolio\Unreal\Project\UE_PUBG\Source\UE_PUBG\InvenUI\Panel\ItemPanel\C_BasicItemPanelWidget.cpp", "C++", 1, 0, 1, 4, 6
"c:\Users\wadan\Desktop\SGA\Portfolio\Unreal\Project\UE_PUBG\Source\UE_PUBG\InvenUI\Panel\ItemPanel\C_BasicItemPanelWidget.h", "C++", 9, 0, 4, 5, 18
"c:\Users\wadan\Desktop\SGA\Portfolio\Unreal\Project\UE_PUBG\Source\UE_PUBG\InvenUI\Panel\ItemPanel\C_InventoryItemPanelWidget.cpp", "C++", 1, 0, 1, 4, 6
"c:\Users\wadan\Desktop\SGA\Portfolio\Unreal\Project\UE_PUBG\Source\UE_PUBG\InvenUI\Panel\ItemPanel\C_InventoryItemPanelWidget.h", "C++", 9, 0, 4, 5, 18
"c:\Users\wadan\Desktop\SGA\Portfolio\Unreal\Project\UE_PUBG\Source\UE_PUBG\InvenUI\Panel\ItemPanel\EquipmentPanel\C_EquipmentPanelWdiget.cpp", "C++", 1, 0, 1, 4, 6
"c:\Users\wadan\Desktop\SGA\Portfolio\Unreal\Project\UE_PUBG\Source\UE_PUBG\InvenUI\Panel\ItemPanel\EquipmentPanel\C_EquipmentPanelWdiget.h", "C++", 9, 0, 4, 5, 18
"c:\Users\wadan\Desktop\SGA\Portfolio\Unreal\Project\UE_PUBG\Source\UE_PUBG\InvenUserInterface\C_BasicSlotWidget.cpp", "C++", 57, 0, 14, 30, 101
"c:\Users\wadan\Desktop\SGA\Portfolio\Unreal\Project\UE_PUBG\Source\UE_PUBG\InvenUserInterface\C_BasicSlotWidget.h", "C++", 23, 0, 5, 12, 40
"c:\Users\wadan\Desktop\SGA\Portfolio\Unreal\Project\UE_PUBG\Source\UE_PUBG\InvenUserInterface\C_BasicUserWidget.cpp", "C++", 1, 0, 1, 4, 6
"c:\Users\wadan\Desktop\SGA\Portfolio\Unreal\Project\UE_PUBG\Source\UE_PUBG\InvenUserInterface\C_BasicUserWidget.h", "C++", 9, 0, 4, 5, 18
"c:\Users\wadan\Desktop\SGA\Portfolio\Unreal\Project\UE_PUBG\Source\UE_PUBG\InvenUserInterface\C_CustomListView.cpp", "C++", 11, 0, 9, 7, 27
"c:\Users\wadan\Desktop\SGA\Portfolio\Unreal\Project\UE_PUBG\Source\UE_PUBG\InvenUserInterface\C_CustomListView.h", "C++", 19, 0, 5, 10, 34
"c:\Users\wadan\Desktop\SGA\Portfolio\Unreal\Project\UE_PUBG\Source\UE_PUBG\InvenUserInterface\C_DragDropOperation.cpp", "C++", 1, 0, 1, 4, 6
"c:\Users\wadan\Desktop\SGA\Portfolio\Unreal\Project\UE_PUBG\Source\UE_PUBG\InvenUserInterface\C_DragDropOperation.h", "C++", 21, 0, 4, 9, 34
"c:\Users\wadan\Desktop\SGA\Portfolio\Unreal\Project\UE_PUBG\Source\UE_PUBG\InvenUserInterface\C_EquipSlot.cpp", "C++", 68, 0, 12, 13, 93
"c:\Users\wadan\Desktop\SGA\Portfolio\Unreal\Project\UE_PUBG\Source\UE_PUBG\InvenUserInterface\C_EquipSlot.h", "C++", 21, 0, 16, 13, 50
"c:\Users\wadan\Desktop\SGA\Portfolio\Unreal\Project\UE_PUBG\Source\UE_PUBG\InvenUserInterface\C_EquipmentPanel.cpp", "C++", 40, 0, 1, 10, 51
"c:\Users\wadan\Desktop\SGA\Portfolio\Unreal\Project\UE_PUBG\Source\UE_PUBG\InvenUserInterface\C_EquipmentPanel.h", "C++", 37, 0, 4, 18, 59
"c:\Users\wadan\Desktop\SGA\Portfolio\Unreal\Project\UE_PUBG\Source\UE_PUBG\InvenUserInterface\C_InvenUiWidget.cpp", "C++", 178, 0, 51, 72, 301
"c:\Users\wadan\Desktop\SGA\Portfolio\Unreal\Project\UE_PUBG\Source\UE_PUBG\InvenUserInterface\C_InvenUiWidget.h", "C++", 67, 0, 15, 39, 121
"c:\Users\wadan\Desktop\SGA\Portfolio\Unreal\Project\UE_PUBG\Source\UE_PUBG\InvenUserInterface\C_ItemBarWidget.cpp", "C++", 170, 0, 81, 66, 317
"c:\Users\wadan\Desktop\SGA\Portfolio\Unreal\Project\UE_PUBG\Source\UE_PUBG\InvenUserInterface\C_ItemBarWidget.h", "C++", 48, 0, 18, 26, 92
"c:\Users\wadan\Desktop\SGA\Portfolio\Unreal\Project\UE_PUBG\Source\UE_PUBG\InvenUserInterface\C_MainGunWidget.cpp", "C++", 112, 0, 17, 39, 168
"c:\Users\wadan\Desktop\SGA\Portfolio\Unreal\Project\UE_PUBG\Source\UE_PUBG\InvenUserInterface\C_MainGunWidget.h", "C++", 31, 0, 12, 19, 62
"c:\Users\wadan\Desktop\SGA\Portfolio\Unreal\Project\UE_PUBG\Source\UE_PUBG\InvenUserInterface\C_MyItemListWidget.cpp", "C++", 82, 0, 6, 20, 108
"c:\Users\wadan\Desktop\SGA\Portfolio\Unreal\Project\UE_PUBG\Source\UE_PUBG\InvenUserInterface\C_MyItemListWidget.h", "C++", 25, 0, 14, 14, 53
"c:\Users\wadan\Desktop\SGA\Portfolio\Unreal\Project\UE_PUBG\Source\UE_PUBG\InvenUserInterface\C_ThrowableWidget.cpp", "C++", 102, 0, 4, 17, 123
"c:\Users\wadan\Desktop\SGA\Portfolio\Unreal\Project\UE_PUBG\Source\UE_PUBG\InvenUserInterface\C_ThrowableWidget.h", "C++", 32, 0, 10, 20, 62
"c:\Users\wadan\Desktop\SGA\Portfolio\Unreal\Project\UE_PUBG\Source\UE_PUBG\Item\AttachmentActors\AttachmentActor.cpp", "C++", 13, 0, 5, 10, 28
"c:\Users\wadan\Desktop\SGA\Portfolio\Unreal\Project\UE_PUBG\Source\UE_PUBG\Item\AttachmentActors\AttachmentActor.h", "C++", 32, 0, 4, 7, 43
"c:\Users\wadan\Desktop\SGA\Portfolio\Unreal\Project\UE_PUBG\Source\UE_PUBG\Item\AttachmentActors\C_Attachment_Compensator.cpp", "C++", 46, 0, 1, 10, 57
"c:\Users\wadan\Desktop\SGA\Portfolio\Unreal\Project\UE_PUBG\Source\UE_PUBG\Item\AttachmentActors\C_Attachment_Compensator.h", "C++", 18, 0, 7, 7, 32
"c:\Users\wadan\Desktop\SGA\Portfolio\Unreal\Project\UE_PUBG\Source\UE_PUBG\Item\AttachmentActors\C_Attachment_RedDot.cpp", "C++", 42, 0, 1, 13, 56
"c:\Users\wadan\Desktop\SGA\Portfolio\Unreal\Project\UE_PUBG\Source\UE_PUBG\Item\AttachmentActors\C_Attachment_RedDot.h", "C++", 17, 0, 7, 6, 30
"c:\Users\wadan\Desktop\SGA\Portfolio\Unreal\Project\UE_PUBG\Source\UE_PUBG\Item\AttachmentActors\C_Attachment_Scope4X.cpp", "C++", 61, 0, 2, 11, 74
"c:\Users\wadan\Desktop\SGA\Portfolio\Unreal\Project\UE_PUBG\Source\UE_PUBG\Item\AttachmentActors\C_Attachment_Scope4X.h", "C++", 19, 0, 7, 7, 33
"c:\Users\wadan\Desktop\SGA\Portfolio\Unreal\Project\UE_PUBG\Source\UE_PUBG\Item\AttachmentActors\C_Attachment_VertGrip.cpp", "C++", 47, 0, 1, 12, 60
"c:\Users\wadan\Desktop\SGA\Portfolio\Unreal\Project\UE_PUBG\Source\UE_PUBG\Item\AttachmentActors\C_Attachment_VertGrip.h", "C++", 18, 0, 7, 7, 32
"c:\Users\wadan\Desktop\SGA\Portfolio\Unreal\Project\UE_PUBG\Source\UE_PUBG\Item\Attachment\C_AttachableItem.cpp", "C++", 62, 0, 5, 15, 82
"c:\Users\wadan\Desktop\SGA\Portfolio\Unreal\Project\UE_PUBG\Source\UE_PUBG\Item\Attachment\C_AttachableItem.h", "C++", 19, 0, 4, 10, 33
"c:\Users\wadan\Desktop\SGA\Portfolio\Unreal\Project\UE_PUBG\Source\UE_PUBG\Item\C_Item.cpp", "C++", 163, 0, 20, 40, 223
"c:\Users\wadan\Desktop\SGA\Portfolio\Unreal\Project\UE_PUBG\Source\UE_PUBG\Item\C_Item.h", "C++", 161, 0, 56, 59, 276
"c:\Users\wadan\Desktop\SGA\Portfolio\Unreal\Project\UE_PUBG\Source\UE_PUBG\Item\ConsumableItem\Boosting\C_EnergyDrink.cpp", "C++", 41, 0, 1, 16, 58
"c:\Users\wadan\Desktop\SGA\Portfolio\Unreal\Project\UE_PUBG\Source\UE_PUBG\Item\ConsumableItem\Boosting\C_EnergyDrink.h", "C++", 19, 0, 7, 11, 37
"c:\Users\wadan\Desktop\SGA\Portfolio\Unreal\Project\UE_PUBG\Source\UE_PUBG\Item\ConsumableItem\Boosting\C_PainKiller.cpp", "C++", 41, 0, 1, 17, 59
"c:\Users\wadan\Desktop\SGA\Portfolio\Unreal\Project\UE_PUBG\Source\UE_PUBG\Item\ConsumableItem\Boosting\C_PainKiller.h", "C++", 19, 0, 7, 11, 37
"c:\Users\wadan\Desktop\SGA\Portfolio\Unreal\Project\UE_PUBG\Source\UE_PUBG\Item\ConsumableItem\C_BoostItem.cpp", "C++", 38, 0, 1, 14, 53
"c:\Users\wadan\Desktop\SGA\Portfolio\Unreal\Project\UE_PUBG\Source\UE_PUBG\Item\ConsumableItem\C_BoostItem.h", "C++", 22, 0, 4, 16, 42
"c:\Users\wadan\Desktop\SGA\Portfolio\Unreal\Project\UE_PUBG\Source\UE_PUBG\Item\ConsumableItem\C_ConsumableItem.cpp", "C++", 302, 0, 52, 111, 465
"c:\Users\wadan\Desktop\SGA\Portfolio\Unreal\Project\UE_PUBG\Source\UE_PUBG\Item\ConsumableItem\C_ConsumableItem.h", "C++", 64, 0, 36, 49, 149
"c:\Users\wadan\Desktop\SGA\Portfolio\Unreal\Project\UE_PUBG\Source\UE_PUBG\Item\ConsumableItem\C_HealItem.cpp", "C++", 42, 0, 2, 13, 57
"c:\Users\wadan\Desktop\SGA\Portfolio\Unreal\Project\UE_PUBG\Source\UE_PUBG\Item\ConsumableItem\C_HealItem.h", "C++", 24, 0, 5, 16, 45
"c:\Users\wadan\Desktop\SGA\Portfolio\Unreal\Project\UE_PUBG\Source\UE_PUBG\Item\ConsumableItem\Healing\C_Bandage.cpp", "C++", 67, 0, 3, 21, 91
"c:\Users\wadan\Desktop\SGA\Portfolio\Unreal\Project\UE_PUBG\Source\UE_PUBG\Item\ConsumableItem\Healing\C_Bandage.h", "C++", 28, 0, 8, 18, 54
"c:\Users\wadan\Desktop\SGA\Portfolio\Unreal\Project\UE_PUBG\Source\UE_PUBG\Item\ConsumableItem\Healing\C_FirstAidKit.cpp", "C++", 55, 0, 2, 21, 78
"c:\Users\wadan\Desktop\SGA\Portfolio\Unreal\Project\UE_PUBG\Source\UE_PUBG\Item\ConsumableItem\Healing\C_FirstAidKit.h", "C++", 21, 0, 7, 12, 40
"c:\Users\wadan\Desktop\SGA\Portfolio\Unreal\Project\UE_PUBG\Source\UE_PUBG\Item\ConsumableItem\Healing\C_MedKit.cpp", "C++", 73, 0, 6, 25, 104
"c:\Users\wadan\Desktop\SGA\Portfolio\Unreal\Project\UE_PUBG\Source\UE_PUBG\Item\ConsumableItem\Healing\C_MedKit.h", "C++", 28, 0, 7, 16, 51
"c:\Users\wadan\Desktop\SGA\Portfolio\Unreal\Project\UE_PUBG\Source\UE_PUBG\Item\Equipment\C_BackPack.cpp", "C++", 143, 0, 56, 66, 265
"c:\Users\wadan\Desktop\SGA\Portfolio\Unreal\Project\UE_PUBG\Source\UE_PUBG\Item\Equipment\C_BackPack.h", "C++", 28, 0, 22, 23, 73
"c:\Users\wadan\Desktop\SGA\Portfolio\Unreal\Project\UE_PUBG\Source\UE_PUBG\Item\Equipment\C_EquipableItem.cpp", "C++", 52, 0, 6, 16, 74
"c:\Users\wadan\Desktop\SGA\Portfolio\Unreal\Project\UE_PUBG\Source\UE_PUBG\Item\Equipment\C_EquipableItem.h", "C++", 35, 0, 10, 22, 67
"c:\Users\wadan\Desktop\SGA\Portfolio\Unreal\Project\UE_PUBG\Source\UE_PUBG\Item\Equipment\C_Helmet.cpp", "C++", 1, 0, 1, 4, 6
"c:\Users\wadan\Desktop\SGA\Portfolio\Unreal\Project\UE_PUBG\Source\UE_PUBG\Item\Equipment\C_Helmet.h", "C++", 11, 0, 4, 6, 21
"c:\Users\wadan\Desktop\SGA\Portfolio\Unreal\Project\UE_PUBG\Source\UE_PUBG\Item\Equipment\C_Vest.cpp", "C++", 60, 0, 9, 18, 87
"c:\Users\wadan\Desktop\SGA\Portfolio\Unreal\Project\UE_PUBG\Source\UE_PUBG\Item\Equipment\C_Vest.h", "C++", 20, 0, 4, 12, 36
"c:\Users\wadan\Desktop\SGA\Portfolio\Unreal\Project\UE_PUBG\Source\UE_PUBG\Item\ItemBullet\C_Item_Bullet.cpp", "C++", 80, 0, 4, 22, 106
"c:\Users\wadan\Desktop\SGA\Portfolio\Unreal\Project\UE_PUBG\Source\UE_PUBG\Item\ItemBullet\C_Item_Bullet.h", "C++", 29, 0, 6, 7, 42
"c:\Users\wadan\Desktop\SGA\Portfolio\Unreal\Project\UE_PUBG\Source\UE_PUBG\Item\Weapon\C_Weapon.cpp", "C++", 244, 0, 19, 70, 333
"c:\Users\wadan\Desktop\SGA\Portfolio\Unreal\Project\UE_PUBG\Source\UE_PUBG\Item\Weapon\C_Weapon.h", "C++", 61, 0, 57, 42, 160
"c:\Users\wadan\Desktop\SGA\Portfolio\Unreal\Project\UE_PUBG\Source\UE_PUBG\Item\Weapon\Gun\C_AR.cpp", "C++", 37, 0, 2, 10, 49
"c:\Users\wadan\Desktop\SGA\Portfolio\Unreal\Project\UE_PUBG\Source\UE_PUBG\Item\Weapon\Gun\C_AR.h", "C++", 16, 0, 6, 7, 29
"c:\Users\wadan\Desktop\SGA\Portfolio\Unreal\Project\UE_PUBG\Source\UE_PUBG\Item\Weapon\Gun\C_Bullet.cpp", "C++", 169, 0, 34, 60, 263
"c:\Users\wadan\Desktop\SGA\Portfolio\Unreal\Project\UE_PUBG\Source\UE_PUBG\Item\Weapon\Gun\C_Bullet.h", "C++", 56, 0, 11, 20, 87
"c:\Users\wadan\Desktop\SGA\Portfolio\Unreal\Project\UE_PUBG\Source\UE_PUBG\Item\Weapon\Gun\C_Gun.cpp", "C++", 762, 0, 123, 159, 1044
"c:\Users\wadan\Desktop\SGA\Portfolio\Unreal\Project\UE_PUBG\Source\UE_PUBG\Item\Weapon\Gun\C_Gun.h", "C++", 208, 0, 22, 61, 291
"c:\Users\wadan\Desktop\SGA\Portfolio\Unreal\Project\UE_PUBG\Source\UE_PUBG\Item\Weapon\Gun\C_SR.cpp", "C++", 85, 0, 6, 14, 105
"c:\Users\wadan\Desktop\SGA\Portfolio\Unreal\Project\UE_PUBG\Source\UE_PUBG\Item\Weapon\Gun\C_SR.h", "C++", 26, 0, 6, 6, 38
"c:\Users\wadan\Desktop\SGA\Portfolio\Unreal\Project\UE_PUBG\Source\UE_PUBG\Item\Weapon\MeleeWeapon\C_MeleeWeapon.cpp", "C++", 151, 0, 41, 46, 238
"c:\Users\wadan\Desktop\SGA\Portfolio\Unreal\Project\UE_PUBG\Source\UE_PUBG\Item\Weapon\MeleeWeapon\C_MeleeWeapon.h", "C++", 55, 0, 34, 36, 125
"c:\Users\wadan\Desktop\SGA\Portfolio\Unreal\Project\UE_PUBG\Source\UE_PUBG\Item\Weapon\ThrowingWeapon\C_FlashBangExplode.cpp", "C++", 99, 0, 22, 48, 169
"c:\Users\wadan\Desktop\SGA\Portfolio\Unreal\Project\UE_PUBG\Source\UE_PUBG\Item\Weapon\ThrowingWeapon\C_FlashBangExplode.h", "C++", 21, 0, 21, 20, 62
"c:\Users\wadan\Desktop\SGA\Portfolio\Unreal\Project\UE_PUBG\Source\UE_PUBG\Item\Weapon\ThrowingWeapon\C_GrenadeExplode.cpp", "C++", 161, 0, 71, 74, 306
"c:\Users\wadan\Desktop\SGA\Portfolio\Unreal\Project\UE_PUBG\Source\UE_PUBG\Item\Weapon\ThrowingWeapon\C_GrenadeExplode.h", "C++", 24, 0, 29, 21, 74
"c:\Users\wadan\Desktop\SGA\Portfolio\Unreal\Project\UE_PUBG\Source\UE_PUBG\Item\Weapon\ThrowingWeapon\C_ScreenShotWidget.cpp", "C++", 17, 0, 13, 12, 42
"c:\Users\wadan\Desktop\SGA\Portfolio\Unreal\Project\UE_PUBG\Source\UE_PUBG\Item\Weapon\ThrowingWeapon\C_ScreenShotWidget.h", "C++", 17, 0, 4, 12, 33
"c:\Users\wadan\Desktop\SGA\Portfolio\Unreal\Project\UE_PUBG\Source\UE_PUBG\Item\Weapon\ThrowingWeapon\C_SmokeGrndExplode.cpp", "C++", 14, 0, 1, 8, 23
"c:\Users\wadan\Desktop\SGA\Portfolio\Unreal\Project\UE_PUBG\Source\UE_PUBG\Item\Weapon\ThrowingWeapon\C_SmokeGrndExplode.h", "C++", 12, 0, 1, 8, 21
"c:\Users\wadan\Desktop\SGA\Portfolio\Unreal\Project\UE_PUBG\Source\UE_PUBG\Item\Weapon\ThrowingWeapon\C_ThrowingWeapon.cpp", "C++", 771, 0, 176, 278, 1225
"c:\Users\wadan\Desktop\SGA\Portfolio\Unreal\Project\UE_PUBG\Source\UE_PUBG\Item\Weapon\ThrowingWeapon\C_ThrowingWeapon.h", "C++", 159, 0, 73, 102, 334
"c:\Users\wadan\Desktop\SGA\Portfolio\Unreal\Project\UE_PUBG\Source\UE_PUBG\Item\Weapon\ThrowingWeapon\I_ExplodeStrategy.cpp", "C++", 1, 0, 2, 4, 7
"c:\Users\wadan\Desktop\SGA\Portfolio\Unreal\Project\UE_PUBG\Source\UE_PUBG\Item\Weapon\ThrowingWeapon\I_ExplodeStrategy.h", "C++", 15, 0, 10, 7, 32
"c:\Users\wadan\Desktop\SGA\Portfolio\Unreal\Project\UE_PUBG\Source\UE_PUBG\Item\Weapon\WeaponStrategy\C_GunStrategy.cpp", "C++", 157, 0, 19, 47, 223
"c:\Users\wadan\Desktop\SGA\Portfolio\Unreal\Project\UE_PUBG\Source\UE_PUBG\Item\Weapon\WeaponStrategy\C_GunStrategy.h", "C++", 24, 0, 4, 11, 39
"c:\Users\wadan\Desktop\SGA\Portfolio\Unreal\Project\UE_PUBG\Source\UE_PUBG\Item\Weapon\WeaponStrategy\C_MeleeWeaponStrategy.cpp", "C++", 50, 0, 1, 24, 75
"c:\Users\wadan\Desktop\SGA\Portfolio\Unreal\Project\UE_PUBG\Source\UE_PUBG\Item\Weapon\WeaponStrategy\C_MeleeWeaponStrategy.h", "C++", 19, 0, 4, 11, 34
"c:\Users\wadan\Desktop\SGA\Portfolio\Unreal\Project\UE_PUBG\Source\UE_PUBG\Item\Weapon\WeaponStrategy\C_ThrowingWeaponStrategy.cpp", "C++", 56, 0, 2, 24, 82
"c:\Users\wadan\Desktop\SGA\Portfolio\Unreal\Project\UE_PUBG\Source\UE_PUBG\Item\Weapon\WeaponStrategy\C_ThrowingWeaponStrategy.h", "C++", 19, 0, 5, 11, 35
"c:\Users\wadan\Desktop\SGA\Portfolio\Unreal\Project\UE_PUBG\Source\UE_PUBG\Item\Weapon\WeaponStrategy\I_WeaponButtonStrategy.cpp", "C++", 1, 0, 2, 4, 7
"c:\Users\wadan\Desktop\SGA\Portfolio\Unreal\Project\UE_PUBG\Source\UE_PUBG\Item\Weapon\WeaponStrategy\I_WeaponButtonStrategy.h", "C++", 22, 0, 54, 17, 93
"c:\Users\wadan\Desktop\SGA\Portfolio\Unreal\Project\UE_PUBG\Source\UE_PUBG\MagneticField\C_MagneticFieldManager.cpp", "C++", 142, 0, 21, 64, 227
"c:\Users\wadan\Desktop\SGA\Portfolio\Unreal\Project\UE_PUBG\Source\UE_PUBG\MagneticField\C_MagneticFieldManager.h", "C++", 84, 0, 39, 46, 169
"c:\Users\wadan\Desktop\SGA\Portfolio\Unreal\Project\UE_PUBG\Source\UE_PUBG\MagneticField\C_MagneticWall.cpp", "C++", 26, 0, 6, 13, 45
"c:\Users\wadan\Desktop\SGA\Portfolio\Unreal\Project\UE_PUBG\Source\UE_PUBG\MagneticField\C_MagneticWall.h", "C++", 19, 0, 4, 12, 35
"c:\Users\wadan\Desktop\SGA\Portfolio\Unreal\Project\UE_PUBG\Source\UE_PUBG\MyWaterBody.cpp", "C++", 1, 0, 1, 4, 6
"c:\Users\wadan\Desktop\SGA\Portfolio\Unreal\Project\UE_PUBG\Source\UE_PUBG\MyWaterBody.h", "C++", 9, 0, 4, 5, 18
"c:\Users\wadan\Desktop\SGA\Portfolio\Unreal\Project\UE_PUBG\Source\UE_PUBG\Singleton\C_GameSceneManager.cpp", "C++", 74, 0, 16, 24, 114
"c:\Users\wadan\Desktop\SGA\Portfolio\Unreal\Project\UE_PUBG\Source\UE_PUBG\Singleton\C_GameSceneManager.h", "C++", 43, 0, 15, 30, 88
"c:\Users\wadan\Desktop\SGA\Portfolio\Unreal\Project\UE_PUBG\Source\UE_PUBG\UE_PUBG.Build.cs", "C#", 0, 25, 17, 9, 51
"c:\Users\wadan\Desktop\SGA\Portfolio\Unreal\Project\UE_PUBG\Source\UE_PUBG\UE_PUBG.cpp", "C++", 3, 0, 1, 3, 7
"c:\Users\wadan\Desktop\SGA\Portfolio\Unreal\Project\UE_PUBG\Source\UE_PUBG\UE_PUBG.h", "C++", 2, 0, 1, 3, 6
"c:\Users\wadan\Desktop\SGA\Portfolio\Unreal\Project\UE_PUBG\Source\UE_PUBG\UE_PUBGCharacter.cpp", "C++", 79, 0, 27, 24, 130
"c:\Users\wadan\Desktop\SGA\Portfolio\Unreal\Project\UE_PUBG\Source\UE_PUBG\UE_PUBGCharacter.h", "C++", 39, 0, 13, 22, 74
"c:\Users\wadan\Desktop\SGA\Portfolio\Unreal\Project\UE_PUBG\Source\UE_PUBG\UE_PUBGGameMode.cpp", "C++", 14, 0, 6, 6, 26
"c:\Users\wadan\Desktop\SGA\Portfolio\Unreal\Project\UE_PUBG\Source\UE_PUBG\UE_PUBGGameMode.h", "C++", 11, 0, 1, 8, 20
"c:\Users\wadan\Desktop\SGA\Portfolio\Unreal\Project\UE_PUBG\Source\UE_PUBG\Utility\C_TimelineComponent.cpp", "C++", 0, 0, 0, 1, 1
"c:\Users\wadan\Desktop\SGA\Portfolio\Unreal\Project\UE_PUBG\Source\UE_PUBG\Utility\C_TimelineUtility.cpp", "C++", 109, 0, 16, 25, 150
"c:\Users\wadan\Desktop\SGA\Portfolio\Unreal\Project\UE_PUBG\Source\UE_PUBG\Utility\C_TimelineUtility.h", "C++", 59, 0, 9, 20, 88
"c:\Users\wadan\Desktop\SGA\Portfolio\Unreal\Project\UE_PUBG\Source\UE_PUBG\Utility\C_Util.cpp", "C++", 47, 0, 1, 13, 61
"c:\Users\wadan\Desktop\SGA\Portfolio\Unreal\Project\UE_PUBG\Source\UE_PUBG\Utility\C_Util.h", "C++", 21, 0, 4, 8, 33
"Total", "-", 15427, 25, 4000, 6263, 25715