"filename", "language", "C++", "comment", "blank", "total"
"c:\Users\wadan\Desktop\SGA\Portfolio\Unreal\Project\UE_PUBG\Source\UE_PUBG\Character\C_AnimBasicCharacter.cpp", "C++", 72, 20, 22, 114
"c:\Users\wadan\Desktop\SGA\Portfolio\Unreal\Project\UE_PUBG\Source\UE_PUBG\Character\C_AnimBasicCharacter.h", "C++", 25, 1, 8, 34
"c:\Users\wadan\Desktop\SGA\Portfolio\Unreal\Project\UE_PUBG\Source\UE_PUBG\Character\C_BasicCharacter.cpp", "C++", 60, 26, 16, 102
"c:\Users\wadan\Desktop\SGA\Portfolio\Unreal\Project\UE_PUBG\Source\UE_PUBG\Character\C_BasicCharacter.h", "C++", 39, 10, 14, 63
"c:\Users\wadan\Desktop\SGA\Portfolio\Unreal\Project\UE_PUBG\Source\UE_PUBG\Character\C_Player.cpp", "C++", 161, 61, 37, 259
"c:\Users\wadan\Desktop\SGA\Portfolio\Unreal\Project\UE_PUBG\Source\UE_PUBG\Character\C_Player.h", "C++", 23, 19, 13, 55
"c:\Users\wadan\Desktop\SGA\Portfolio\Unreal\Project\UE_PUBG\Source\UE_PUBG\Character\Component\C_CrosshairWidgetComponent.cpp", "C++", 184, 11, 32, 227
"c:\Users\wadan\Desktop\SGA\Portfolio\Unreal\Project\UE_PUBG\Source\UE_PUBG\Character\Component\C_CrosshairWidgetComponent.h", "C++", 64, 8, 10, 82
"c:\Users\wadan\Desktop\SGA\Portfolio\Unreal\Project\UE_PUBG\Source\UE_PUBG\Character\Component\C_EquippedComponent.cpp", "C++", 26, 2, 10, 38
"c:\Users\wadan\Desktop\SGA\Portfolio\Unreal\Project\UE_PUBG\Source\UE_PUBG\Character\Component\C_EquippedComponent.h", "C++", 6, 0, 2, 8
"c:\Users\wadan\Desktop\SGA\Portfolio\Unreal\Project\UE_PUBG\Source\UE_PUBG\Character\Component\C_InputComponent.cpp", "C++", 24, 19, 5, 48
"c:\Users\wadan\Desktop\SGA\Portfolio\Unreal\Project\UE_PUBG\Source\UE_PUBG\Character\Component\C_InputComponent.h", "C++", 10, 0, 4, 14
"c:\Users\wadan\Desktop\SGA\Portfolio\Unreal\Project\UE_PUBG\Source\UE_PUBG\Character\Component\C_InvenComponent.cpp", "C++", 81, 38, 29, 148
"c:\Users\wadan\Desktop\SGA\Portfolio\Unreal\Project\UE_PUBG\Source\UE_PUBG\Character\Component\C_InvenComponent.h", "C++", 37, 13, 21, 71
"c:\Users\wadan\Desktop\SGA\Portfolio\Unreal\Project\UE_PUBG\Source\UE_PUBG\Character\Component\C_InvenSystem.cpp", "C++", 56, 14, 31, 101
"c:\Users\wadan\Desktop\SGA\Portfolio\Unreal\Project\UE_PUBG\Source\UE_PUBG\Character\Component\C_InvenSystem.h", "C++", 27, 4, 17, 48
"c:\Users\wadan\Desktop\SGA\Portfolio\Unreal\Project\UE_PUBG\Source\UE_PUBG\Character\Component\C_PoseColliderHandlerComponent.cpp", "C++", 42, 33, 15, 90
"c:\Users\wadan\Desktop\SGA\Portfolio\Unreal\Project\UE_PUBG\Source\UE_PUBG\Character\Component\C_PoseColliderHandlerComponent.h", "C++", 8, 23, 10, 41
"c:\Users\wadan\Desktop\SGA\Portfolio\Unreal\Project\UE_PUBG\Source\UE_PUBG\Character\Component\C_SkyDivingComponent.cpp", "C++", 221, 43, 66, 330
"c:\Users\wadan\Desktop\SGA\Portfolio\Unreal\Project\UE_PUBG\Source\UE_PUBG\Character\Component\C_SkyDivingComponent.h", "C++", 102, 32, 51, 185
"c:\Users\wadan\Desktop\SGA\Portfolio\Unreal\Project\UE_PUBG\Source\UE_PUBG\Character\Component\C_StatComponent.cpp", "C++", 23, 0, 3, 26
"c:\Users\wadan\Desktop\SGA\Portfolio\Unreal\Project\UE_PUBG\Source\UE_PUBG\Character\Component\C_StatComponent.h", "C++", 9, 8, 7, 24
"c:\Users\wadan\Desktop\SGA\Portfolio\Unreal\Project\UE_PUBG\Source\UE_PUBG\Character\Component\C_SwimmingComponent.cpp", "C++", 241, 39, 86, 366
"c:\Users\wadan\Desktop\SGA\Portfolio\Unreal\Project\UE_PUBG\Source\UE_PUBG\Character\Component\C_SwimmingComponent.h", "C++", 72, 24, 40, 136
"c:\Users\wadan\Desktop\SGA\Portfolio\Unreal\Project\UE_PUBG\Source\UE_PUBG\HUD\C_HUDWidget.h", "C++", 4, 0, 3, 7
"c:\Users\wadan\Desktop\SGA\Portfolio\Unreal\Project\UE_PUBG\Source\UE_PUBG\HUD\C_MainMapWidget.cpp", "C++", 1, 0, 1, 2
"c:\Users\wadan\Desktop\SGA\Portfolio\Unreal\Project\UE_PUBG\Source\UE_PUBG\HUD\C_OxygenWidget.cpp", "C++", 1, 1, 4, 6
"c:\Users\wadan\Desktop\SGA\Portfolio\Unreal\Project\UE_PUBG\Source\UE_PUBG\HUD\C_OxygenWidget.h", "C++", 12, 7, 8, 27
"c:\Users\wadan\Desktop\SGA\Portfolio\Unreal\Project\UE_PUBG\Source\UE_PUBG\InvenUserInterface\C_CustomListView.cpp", "C++", 4, 2, 4, 10
"c:\Users\wadan\Desktop\SGA\Portfolio\Unreal\Project\UE_PUBG\Source\UE_PUBG\InvenUserInterface\C_CustomListView.h", "C++", 15, 4, 8, 27
"c:\Users\wadan\Desktop\SGA\Portfolio\Unreal\Project\UE_PUBG\Source\UE_PUBG\InvenUserInterface\C_EquipSlot.h", "C++", 6, 0, 0, 6
"c:\Users\wadan\Desktop\SGA\Portfolio\Unreal\Project\UE_PUBG\Source\UE_PUBG\InvenUserInterface\C_InvenUiWidget.cpp", "C++", 112, 28, 51, 191
"c:\Users\wadan\Desktop\SGA\Portfolio\Unreal\Project\UE_PUBG\Source\UE_PUBG\InvenUserInterface\C_InvenUiWidget.h", "C++", 28, 9, 20, 57
"c:\Users\wadan\Desktop\SGA\Portfolio\Unreal\Project\UE_PUBG\Source\UE_PUBG\InvenUserInterface\C_ItemBarWidget.cpp", "C++", 116, 26, 38, 180
"c:\Users\wadan\Desktop\SGA\Portfolio\Unreal\Project\UE_PUBG\Source\UE_PUBG\InvenUserInterface\C_ItemBarWidget.h", "C++", 41, 12, 22, 75
"c:\Users\wadan\Desktop\SGA\Portfolio\Unreal\Project\UE_PUBG\Source\UE_PUBG\InvenUserInterface\C_MainGunWidget.cpp", "C++", 51, 2, 11, 64
"c:\Users\wadan\Desktop\SGA\Portfolio\Unreal\Project\UE_PUBG\Source\UE_PUBG\InvenUserInterface\C_MainGunWidget.h", "C++", 33, 6, 16, 55
"c:\Users\wadan\Desktop\SGA\Portfolio\Unreal\Project\UE_PUBG\Source\UE_PUBG\InvenUserInterface\C_MyItemListWidget.cpp", "C++", 39, 12, 15, 66
"c:\Users\wadan\Desktop\SGA\Portfolio\Unreal\Project\UE_PUBG\Source\UE_PUBG\InvenUserInterface\C_MyItemListWidget.h", "C++", 24, 6, 13, 43
"c:\Users\wadan\Desktop\SGA\Portfolio\Unreal\Project\UE_PUBG\Source\UE_PUBG\InvenUserInterface\C_ThrowableWidget.cpp", "C++", 53, 1, 8, 62
"c:\Users\wadan\Desktop\SGA\Portfolio\Unreal\Project\UE_PUBG\Source\UE_PUBG\InvenUserInterface\C_ThrowableWidget.h", "C++", 34, 4, 18, 56
"c:\Users\wadan\Desktop\SGA\Portfolio\Unreal\Project\UE_PUBG\Source\UE_PUBG\Item\Attachment\C_AttachableItem.cpp", "C++", 62, 3, 9, 74
"c:\Users\wadan\Desktop\SGA\Portfolio\Unreal\Project\UE_PUBG\Source\UE_PUBG\Item\Attachment\C_AttachableItem.h", "C++", 8, 0, 3, 11
"c:\Users\wadan\Desktop\SGA\Portfolio\Unreal\Project\UE_PUBG\Source\UE_PUBG\Item\C_Item.cpp", "C++", 0, 0, -1, -1
"c:\Users\wadan\Desktop\SGA\Portfolio\Unreal\Project\UE_PUBG\Source\UE_PUBG\Item\C_Item.h", "C++", 39, 25, 24, 88
"c:\Users\wadan\Desktop\SGA\Portfolio\Unreal\Project\UE_PUBG\Source\UE_PUBG\Item\ConsumableItem\C_ConsumableItem.cpp", "C++", 3, -2, 0, 1
"c:\Users\wadan\Desktop\SGA\Portfolio\Unreal\Project\UE_PUBG\Source\UE_PUBG\Item\Equipment\C_BackPack.cpp", "C++", 8, 5, 6, 19
"c:\Users\wadan\Desktop\SGA\Portfolio\Unreal\Project\UE_PUBG\Source\UE_PUBG\Item\Equipment\C_BackPack.h", "C++", 0, 2, 2, 4
"c:\Users\wadan\Desktop\SGA\Portfolio\Unreal\Project\UE_PUBG\Source\UE_PUBG\Item\Equipment\C_EquipableItem.cpp", "C++", 1, 0, 0, 1
"c:\Users\wadan\Desktop\SGA\Portfolio\Unreal\Project\UE_PUBG\Source\UE_PUBG\Item\Equipment\C_EquipableItem.h", "C++", 0, 2, 3, 5
"c:\Users\wadan\Desktop\SGA\Portfolio\Unreal\Project\UE_PUBG\Source\UE_PUBG\Item\Weapon\C_Weapon.cpp", "C++", 33, 0, 4, 37
"c:\Users\wadan\Desktop\SGA\Portfolio\Unreal\Project\UE_PUBG\Source\UE_PUBG\Item\Weapon\C_Weapon.h", "C++", 2, 4, 3, 9
"c:\Users\wadan\Desktop\SGA\Portfolio\Unreal\Project\UE_PUBG\Source\UE_PUBG\Item\Weapon\Gun\C_Bullet.cpp", "C++", 6, 8, 1, 15
"c:\Users\wadan\Desktop\SGA\Portfolio\Unreal\Project\UE_PUBG\Source\UE_PUBG\Item\Weapon\Gun\C_Bullet.h", "C++", 9, 0, 3, 12
"c:\Users\wadan\Desktop\SGA\Portfolio\Unreal\Project\UE_PUBG\Source\UE_PUBG\Item\Weapon\Gun\C_Gun.cpp", "C++", 257, 24, 47, 328
"c:\Users\wadan\Desktop\SGA\Portfolio\Unreal\Project\UE_PUBG\Source\UE_PUBG\Item\Weapon\Gun\C_Gun.h", "C++", 50, 2, 19, 71
"c:\Users\wadan\Desktop\SGA\Portfolio\Unreal\Project\UE_PUBG\Source\UE_PUBG\Item\Weapon\MeleeWeapon\C_MeleeWeapon.cpp", "C++", 13, 1, 2, 16
"c:\Users\wadan\Desktop\SGA\Portfolio\Unreal\Project\UE_PUBG\Source\UE_PUBG\Item\Weapon\MeleeWeapon\C_MeleeWeapon.h", "C++", 2, 0, 1, 3
"c:\Users\wadan\Desktop\SGA\Portfolio\Unreal\Project\UE_PUBG\Source\UE_PUBG\Item\Weapon\ThrowingWeapon\C_ThrowingWeapon.cpp", "C++", 147, 33, 45, 225
"c:\Users\wadan\Desktop\SGA\Portfolio\Unreal\Project\UE_PUBG\Source\UE_PUBG\Item\Weapon\ThrowingWeapon\C_ThrowingWeapon.h", "C++", 8, 1, 9, 18
"c:\Users\wadan\Desktop\SGA\Portfolio\Unreal\Project\UE_PUBG\Source\UE_PUBG\Item\Weapon\WeaponStrategy\C_GunStrategy.cpp", "C++", 31, 3, 17, 51
"c:\Users\wadan\Desktop\SGA\Portfolio\Unreal\Project\UE_PUBG\Source\UE_PUBG\MyWaterBody.cpp", "C++", 1, 1, 4, 6
"c:\Users\wadan\Desktop\SGA\Portfolio\Unreal\Project\UE_PUBG\Source\UE_PUBG\MyWaterBody.h", "C++", 9, 4, 5, 18
"c:\Users\wadan\Desktop\SGA\Portfolio\Unreal\Project\UE_PUBG\Source\UE_PUBG\Utility\C_TimelineUtility.cpp", "C++", 102, 15, 20, 137
"c:\Users\wadan\Desktop\SGA\Portfolio\Unreal\Project\UE_PUBG\Source\UE_PUBG\Utility\C_TimelineUtility.h", "C++", 34, 0, 6, 40
"Total", "-", 3012, 699, 1021, 4732