"filename", "language", "C++", "comment", "blank", "total"
"c:\Users\wadan\Desktop\SGA\Portfolio\Unreal\Project\UE_PUBG\Source\UE_PUBG\Airplane\C_Airplane.cpp", "C++", 81, 12, 34, 127
"c:\Users\wadan\Desktop\SGA\Portfolio\Unreal\Project\UE_PUBG\Source\UE_PUBG\Airplane\C_Airplane.h", "C++", 39, 16, 27, 82
"c:\Users\wadan\Desktop\SGA\Portfolio\Unreal\Project\UE_PUBG\Source\UE_PUBG\Airplane\C_AirplaneManager.cpp", "C++", 204, 28, 66, 298
"c:\Users\wadan\Desktop\SGA\Portfolio\Unreal\Project\UE_PUBG\Source\UE_PUBG\Airplane\C_AirplaneManager.h", "C++", 47, 33, 35, 115
"c:\Users\wadan\Desktop\SGA\Portfolio\Unreal\Project\UE_PUBG\Source\UE_PUBG\Character\C_BasicCharacter.cpp", "C++", 7, -3, 1, 5
"c:\Users\wadan\Desktop\SGA\Portfolio\Unreal\Project\UE_PUBG\Source\UE_PUBG\Character\C_BasicCharacter.h", "C++", 7, 0, 3, 10
"c:\Users\wadan\Desktop\SGA\Portfolio\Unreal\Project\UE_PUBG\Source\UE_PUBG\Character\C_Player.cpp", "C++", 3, 0, 0, 3
"c:\Users\wadan\Desktop\SGA\Portfolio\Unreal\Project\UE_PUBG\Source\UE_PUBG\Character\Component\C_AttachableItemMeshComponent.cpp", "C++", 148, 31, 43, 222
"c:\Users\wadan\Desktop\SGA\Portfolio\Unreal\Project\UE_PUBG\Source\UE_PUBG\Character\Component\C_AttachableItemMeshComponent.h", "C++", 26, 4, 10, 40
"c:\Users\wadan\Desktop\SGA\Portfolio\Unreal\Project\UE_PUBG\Source\UE_PUBG\Character\Component\C_CrosshairWidgetComponent.cpp", "C++", 5, 0, 1, 6
"c:\Users\wadan\Desktop\SGA\Portfolio\Unreal\Project\UE_PUBG\Source\UE_PUBG\Character\Component\C_EquippedComponent.cpp", "C++", 2, 3, 0, 5
"c:\Users\wadan\Desktop\SGA\Portfolio\Unreal\Project\UE_PUBG\Source\UE_PUBG\Character\Component\C_InvenComponent.cpp", "C++", 24, 2, 2, 28
"c:\Users\wadan\Desktop\SGA\Portfolio\Unreal\Project\UE_PUBG\Source\UE_PUBG\Character\Component\C_InvenComponent.h", "C++", 6, 7, 3, 16
"c:\Users\wadan\Desktop\SGA\Portfolio\Unreal\Project\UE_PUBG\Source\UE_PUBG\Character\Component\C_InvenSystem.cpp", "C++", 35, 36, 7, 78
"c:\Users\wadan\Desktop\SGA\Portfolio\Unreal\Project\UE_PUBG\Source\UE_PUBG\Character\Component\C_InvenSystem.h", "C++", 12, 5, 3, 20
"c:\Users\wadan\Desktop\SGA\Portfolio\Unreal\Project\UE_PUBG\Source\UE_PUBG\Character\Component\C_SkyDivingComponent.cpp", "C++", 50, 7, 23, 80
"c:\Users\wadan\Desktop\SGA\Portfolio\Unreal\Project\UE_PUBG\Source\UE_PUBG\Character\Component\C_SkyDivingComponent.h", "C++", 7, 8, 7, 22
"c:\Users\wadan\Desktop\SGA\Portfolio\Unreal\Project\UE_PUBG\Source\UE_PUBG\Character\Component\C_SwimmingComponent.cpp", "C++", 4, 3, 2, 9
"c:\Users\wadan\Desktop\SGA\Portfolio\Unreal\Project\UE_PUBG\Source\UE_PUBG\HUD\C_HUDWidget.h", "C++", 4, 0, 1, 5
"c:\Users\wadan\Desktop\SGA\Portfolio\Unreal\Project\UE_PUBG\Source\UE_PUBG\HUD\C_InstructionWidget.cpp", "C++", 1, 1, 4, 6
"c:\Users\wadan\Desktop\SGA\Portfolio\Unreal\Project\UE_PUBG\Source\UE_PUBG\HUD\C_InstructionWidget.h", "C++", 14, 4, 8, 26
"c:\Users\wadan\Desktop\SGA\Portfolio\Unreal\Project\UE_PUBG\Source\UE_PUBG\HUD\C_MainMapWidget.cpp", "C++", 125, 14, 42, 181
"c:\Users\wadan\Desktop\SGA\Portfolio\Unreal\Project\UE_PUBG\Source\UE_PUBG\HUD\C_MainMapWidget.h", "C++", 16, 10, 10, 36
"c:\Users\wadan\Desktop\SGA\Portfolio\Unreal\Project\UE_PUBG\Source\UE_PUBG\HUD\C_MapWidget.cpp", "C++", 13, 2, 6, 21
"c:\Users\wadan\Desktop\SGA\Portfolio\Unreal\Project\UE_PUBG\Source\UE_PUBG\HUD\C_MapWidget.h", "C++", 19, 0, 13, 32
"c:\Users\wadan\Desktop\SGA\Portfolio\Unreal\Project\UE_PUBG\Source\UE_PUBG\HUD\C_SkyDiveWidget.cpp", "C++", 73, 10, 32, 115
"c:\Users\wadan\Desktop\SGA\Portfolio\Unreal\Project\UE_PUBG\Source\UE_PUBG\HUD\C_SkyDiveWidget.h", "C++", 48, 12, 31, 91
"c:\Users\wadan\Desktop\SGA\Portfolio\Unreal\Project\UE_PUBG\Source\UE_PUBG\InvenUserInterface\C_BasicUserWidget.cpp", "C++", 1, 1, 4, 6
"c:\Users\wadan\Desktop\SGA\Portfolio\Unreal\Project\UE_PUBG\Source\UE_PUBG\InvenUserInterface\C_BasicUserWidget.h", "C++", 9, 4, 5, 18
"c:\Users\wadan\Desktop\SGA\Portfolio\Unreal\Project\UE_PUBG\Source\UE_PUBG\InvenUserInterface\C_CustomListView.cpp", "C++", 7, 7, 3, 17
"c:\Users\wadan\Desktop\SGA\Portfolio\Unreal\Project\UE_PUBG\Source\UE_PUBG\InvenUserInterface\C_CustomListView.h", "C++", 4, 1, 2, 7
"c:\Users\wadan\Desktop\SGA\Portfolio\Unreal\Project\UE_PUBG\Source\UE_PUBG\InvenUserInterface\C_DragDropOperation.cpp", "C++", 1, 1, 4, 6
"c:\Users\wadan\Desktop\SGA\Portfolio\Unreal\Project\UE_PUBG\Source\UE_PUBG\InvenUserInterface\C_DragDropOperation.h", "C++", 14, 4, 7, 25
"c:\Users\wadan\Desktop\SGA\Portfolio\Unreal\Project\UE_PUBG\Source\UE_PUBG\InvenUserInterface\C_InvenUiWidget.cpp", "C++", 10, 45, 1, 56
"c:\Users\wadan\Desktop\SGA\Portfolio\Unreal\Project\UE_PUBG\Source\UE_PUBG\InvenUserInterface\C_InvenUiWidget.h", "C++", 17, 0, 7, 24
"c:\Users\wadan\Desktop\SGA\Portfolio\Unreal\Project\UE_PUBG\Source\UE_PUBG\InvenUserInterface\C_ItemBarWidget.cpp", "C++", 43, 14, 22, 79
"c:\Users\wadan\Desktop\SGA\Portfolio\Unreal\Project\UE_PUBG\Source\UE_PUBG\InvenUserInterface\C_ItemBarWidget.h", "C++", 2, 0, 2, 4
"c:\Users\wadan\Desktop\SGA\Portfolio\Unreal\Project\UE_PUBG\Source\UE_PUBG\InvenUserInterface\C_MainGunWidget.cpp", "C++", 2, 0, 2, 4
"c:\Users\wadan\Desktop\SGA\Portfolio\Unreal\Project\UE_PUBG\Source\UE_PUBG\InvenUserInterface\C_MainGunWidget.h", "C++", 1, 0, 0, 1
"c:\Users\wadan\Desktop\SGA\Portfolio\Unreal\Project\UE_PUBG\Source\UE_PUBG\InvenUserInterface\C_MyItemListWidget.cpp", "C++", 26, -6, 2, 22
"c:\Users\wadan\Desktop\SGA\Portfolio\Unreal\Project\UE_PUBG\Source\UE_PUBG\InvenUserInterface\C_MyItemListWidget.h", "C++", 2, 0, 1, 3
"c:\Users\wadan\Desktop\SGA\Portfolio\Unreal\Project\UE_PUBG\Source\UE_PUBG\InvenUserInterface\C_ThrowableWidget.cpp", "C++", 37, 3, 9, 49
"c:\Users\wadan\Desktop\SGA\Portfolio\Unreal\Project\UE_PUBG\Source\UE_PUBG\InvenUserInterface\C_ThrowableWidget.h", "C++", 3, 0, 2, 5
"c:\Users\wadan\Desktop\SGA\Portfolio\Unreal\Project\UE_PUBG\Source\UE_PUBG\Item\AttachmentActors\AttachmentActor.cpp", "C++", 13, 5, 10, 28
"c:\Users\wadan\Desktop\SGA\Portfolio\Unreal\Project\UE_PUBG\Source\UE_PUBG\Item\AttachmentActors\AttachmentActor.h", "C++", 31, 4, 8, 43
"c:\Users\wadan\Desktop\SGA\Portfolio\Unreal\Project\UE_PUBG\Source\UE_PUBG\Item\AttachmentActors\C_Attachment_RedDot.cpp", "C++", 42, 1, 13, 56
"c:\Users\wadan\Desktop\SGA\Portfolio\Unreal\Project\UE_PUBG\Source\UE_PUBG\Item\AttachmentActors\C_Attachment_RedDot.h", "C++", 17, 7, 6, 30
"c:\Users\wadan\Desktop\SGA\Portfolio\Unreal\Project\UE_PUBG\Source\UE_PUBG\Item\AttachmentActors\C_Attachment_Scope4X.cpp", "C++", 61, 2, 11, 74
"c:\Users\wadan\Desktop\SGA\Portfolio\Unreal\Project\UE_PUBG\Source\UE_PUBG\Item\AttachmentActors\C_Attachment_Scope4X.h", "C++", 19, 7, 7, 33
"c:\Users\wadan\Desktop\SGA\Portfolio\Unreal\Project\UE_PUBG\Source\UE_PUBG\Item\C_Item.cpp", "C++", 27, 12, 8, 47
"c:\Users\wadan\Desktop\SGA\Portfolio\Unreal\Project\UE_PUBG\Source\UE_PUBG\Item\C_Item.h", "C++", 28, 3, 6, 37
"c:\Users\wadan\Desktop\SGA\Portfolio\Unreal\Project\UE_PUBG\Source\UE_PUBG\Item\Weapon\Gun\C_Gun.cpp", "C++", 88, 9, 16, 113
"c:\Users\wadan\Desktop\SGA\Portfolio\Unreal\Project\UE_PUBG\Source\UE_PUBG\Item\Weapon\Gun\C_Gun.h", "C++", 24, 1, 11, 36
"c:\Users\wadan\Desktop\SGA\Portfolio\Unreal\Project\UE_PUBG\Source\UE_PUBG\Item\Weapon\ThrowingWeapon\C_ThrowingWeapon.cpp", "C++", 71, 40, 13, 124
"c:\Users\wadan\Desktop\SGA\Portfolio\Unreal\Project\UE_PUBG\Source\UE_PUBG\Item\Weapon\ThrowingWeapon\C_ThrowingWeapon.h", "C++", 1, 17, 1, 19
"c:\Users\wadan\Desktop\SGA\Portfolio\Unreal\Project\UE_PUBG\Source\UE_PUBG\Item\Weapon\WeaponStrategy\C_GunStrategy.cpp", "C++", 5, 2, 1, 8
"c:\Users\wadan\Desktop\SGA\Portfolio\Unreal\Project\UE_PUBG\Source\UE_PUBG\Singleton\C_GameSceneManager.cpp", "C++", 5, 0, 2, 7
"c:\Users\wadan\Desktop\SGA\Portfolio\Unreal\Project\UE_PUBG\Source\UE_PUBG\Singleton\C_GameSceneManager.h", "C++", 4, 1, 3, 8
"Total", "-", 1635, 430, 603, 2668