"filename", "language", "C#", "C++", "comment", "blank", "total"
"c:\Users\wadan\Desktop\SGA\Portfolio\Unreal\Project\UE_PUBG\Source\UE_PUBG\AI\C_EnemyAIController.cpp", "C++", 0, 1, 1, 4, 6
"c:\Users\wadan\Desktop\SGA\Portfolio\Unreal\Project\UE_PUBG\Source\UE_PUBG\AI\C_EnemyAIController.h", "C++", 0, 9, 4, 5, 18
"c:\Users\wadan\Desktop\SGA\Portfolio\Unreal\Project\UE_PUBG\Source\UE_PUBG\Character\C_BasicCharacter.cpp", "C++", 0, 0, -16, -4, -20
"c:\Users\wadan\Desktop\SGA\Portfolio\Unreal\Project\UE_PUBG\Source\UE_PUBG\Character\C_BasicCharacter.h", "C++", 0, 4, -2, 1, 3
"c:\Users\wadan\Desktop\SGA\Portfolio\Unreal\Project\UE_PUBG\Source\UE_PUBG\Character\C_Enemy.cpp", "C++", 0, 6, 0, 1, 7
"c:\Users\wadan\Desktop\SGA\Portfolio\Unreal\Project\UE_PUBG\Source\UE_PUBG\Character\C_Enemy.h", "C++", 0, 7, 0, 5, 12
"c:\Users\wadan\Desktop\SGA\Portfolio\Unreal\Project\UE_PUBG\Source\UE_PUBG\Character\C_Player.h", "C++", 0, 6, 0, 4, 10
"c:\Users\wadan\Desktop\SGA\Portfolio\Unreal\Project\UE_PUBG\Source\UE_PUBG\Character\Component\C_InputComponent.cpp", "C++", 0, -2, 2, 0, 0
"c:\Users\wadan\Desktop\SGA\Portfolio\Unreal\Project\UE_PUBG\Source\UE_PUBG\Character\Component\C_ParkourComponent.cpp", "C++", 0, 139, 25, 41, 205
"c:\Users\wadan\Desktop\SGA\Portfolio\Unreal\Project\UE_PUBG\Source\UE_PUBG\Character\Component\C_ParkourComponent.h", "C++", 0, 17, 32, 17, 66
"c:\Users\wadan\Desktop\SGA\Portfolio\Unreal\Project\UE_PUBG\Source\UE_PUBG\Item\ConsumableItem\C_ConsumableItem.cpp", "C++", 0, 0, -1, -1, -2
"c:\Users\wadan\Desktop\SGA\Portfolio\Unreal\Project\UE_PUBG\Source\UE_PUBG\UE_PUBG.Build.cs", "C#", 1, 0, 0, 0, 1
"Total", "-", 1, 187, 45, 73, 306