"filename", "language", "C++", "C#", "comment", "blank", "total"
"c:\Users\wadan\Desktop\SGA\Portfolio\Unreal\Project\UE_PUBG\Source\UE_PUBG\AI\C_EnemyAIController.cpp", "C++", 1, 0, 1, 4, 6
"c:\Users\wadan\Desktop\SGA\Portfolio\Unreal\Project\UE_PUBG\Source\UE_PUBG\AI\C_EnemyAIController.h", "C++", 9, 0, 4, 5, 18
"c:\Users\wadan\Desktop\SGA\Portfolio\Unreal\Project\UE_PUBG\Source\UE_PUBG\Airplane\C_Airplane.cpp", "C++", 82, 0, 12, 34, 128
"c:\Users\wadan\Desktop\SGA\Portfolio\Unreal\Project\UE_PUBG\Source\UE_PUBG\Airplane\C_Airplane.h", "C++", 39, 0, 16, 27, 82
"c:\Users\wadan\Desktop\SGA\Portfolio\Unreal\Project\UE_PUBG\Source\UE_PUBG\Airplane\C_AirplaneManager.cpp", "C++", 208, 0, 31, 66, 305
"c:\Users\wadan\Desktop\SGA\Portfolio\Unreal\Project\UE_PUBG\Source\UE_PUBG\Airplane\C_AirplaneManager.h", "C++", 48, 0, 34, 37, 119
"c:\Users\wadan\Desktop\SGA\Portfolio\Unreal\Project\UE_PUBG\Source\UE_PUBG\C_MyMotionWarpingComponent.cpp", "C++", 1, 0, 1, 4, 6
"c:\Users\wadan\Desktop\SGA\Portfolio\Unreal\Project\UE_PUBG\Source\UE_PUBG\C_MyMotionWarpingComponent.h", "C++", 9, 0, 4, 6, 19
"c:\Users\wadan\Desktop\SGA\Portfolio\Unreal\Project\UE_PUBG\Source\UE_PUBG\Character\C_AnimBasicCharacter.cpp", "C++", 219, 0, 50, 63, 332
"c:\Users\wadan\Desktop\SGA\Portfolio\Unreal\Project\UE_PUBG\Source\UE_PUBG\Character\C_AnimBasicCharacter.h", "C++", 101, 0, 8, 46, 155
"c:\Users\wadan\Desktop\SGA\Portfolio\Unreal\Project\UE_PUBG\Source\UE_PUBG\Character\C_AnimPlayer.cpp", "C++", 1, 0, 1, 4, 6
"c:\Users\wadan\Desktop\SGA\Portfolio\Unreal\Project\UE_PUBG\Source\UE_PUBG\Character\C_AnimPlayer.h", "C++", 9, 0, 4, 5, 18
"c:\Users\wadan\Desktop\SGA\Portfolio\Unreal\Project\UE_PUBG\Source\UE_PUBG\Character\C_BasicCharacter.cpp", "C++", 213, 0, 78, 78, 369
"c:\Users\wadan\Desktop\SGA\Portfolio\Unreal\Project\UE_PUBG\Source\UE_PUBG\Character\C_BasicCharacter.h", "C++", 243, 0, 72, 114, 429
"c:\Users\wadan\Desktop\SGA\Portfolio\Unreal\Project\UE_PUBG\Source\UE_PUBG\Character\C_Enemy.cpp", "C++", 7, 0, 1, 5, 13
"c:\Users\wadan\Desktop\SGA\Portfolio\Unreal\Project\UE_PUBG\Source\UE_PUBG\Character\C_Enemy.h", "C++", 16, 0, 4, 10, 30
"c:\Users\wadan\Desktop\SGA\Portfolio\Unreal\Project\UE_PUBG\Source\UE_PUBG\Character\C_Player.cpp", "C++", 824, 0, 238, 266, 1328
"c:\Users\wadan\Desktop\SGA\Portfolio\Unreal\Project\UE_PUBG\Source\UE_PUBG\Character\C_Player.h", "C++", 192, 0, 108, 113, 413
"c:\Users\wadan\Desktop\SGA\Portfolio\Unreal\Project\UE_PUBG\Source\UE_PUBG\Character\C_WorldPingActor.cpp", "C++", 53, 0, 3, 26, 82
"c:\Users\wadan\Desktop\SGA\Portfolio\Unreal\Project\UE_PUBG\Source\UE_PUBG\Character\C_WorldPingActor.h", "C++", 25, 0, 3, 18, 46
"c:\Users\wadan\Desktop\SGA\Portfolio\Unreal\Project\UE_PUBG\Source\UE_PUBG\Character\Component\C_AttachableItemMeshComponent.cpp", "C++", 157, 0, 34, 46, 237
"c:\Users\wadan\Desktop\SGA\Portfolio\Unreal\Project\UE_PUBG\Source\UE_PUBG\Character\Component\C_AttachableItemMeshComponent.h", "C++", 26, 0, 4, 10, 40
"c:\Users\wadan\Desktop\SGA\Portfolio\Unreal\Project\UE_PUBG\Source\UE_PUBG\Character\Component\C_ConsumableUsageMeshComponent.cpp", "C++", 52, 0, 10, 19, 81
"c:\Users\wadan\Desktop\SGA\Portfolio\Unreal\Project\UE_PUBG\Source\UE_PUBG\Character\Component\C_ConsumableUsageMeshComponent.h", "C++", 42, 0, 10, 21, 73
"c:\Users\wadan\Desktop\SGA\Portfolio\Unreal\Project\UE_PUBG\Source\UE_PUBG\Character\Component\C_CrosshairWidgetComponent.cpp", "C++", 189, 0, 11, 33, 233
"c:\Users\wadan\Desktop\SGA\Portfolio\Unreal\Project\UE_PUBG\Source\UE_PUBG\Character\Component\C_CrosshairWidgetComponent.h", "C++", 64, 0, 8, 10, 82
"c:\Users\wadan\Desktop\SGA\Portfolio\Unreal\Project\UE_PUBG\Source\UE_PUBG\Character\Component\C_EquippedComponent.cpp", "C++", 237, 0, 69, 87, 393
"c:\Users\wadan\Desktop\SGA\Portfolio\Unreal\Project\UE_PUBG\Source\UE_PUBG\Character\Component\C_EquippedComponent.h", "C++", 72, 0, 49, 42, 163
"c:\Users\wadan\Desktop\SGA\Portfolio\Unreal\Project\UE_PUBG\Source\UE_PUBG\Character\Component\C_InputComponent.cpp", "C++", 444, 0, 84, 140, 668
"c:\Users\wadan\Desktop\SGA\Portfolio\Unreal\Project\UE_PUBG\Source\UE_PUBG\Character\Component\C_InputComponent.h", "C++", 107, 0, 19, 55, 181
"c:\Users\wadan\Desktop\SGA\Portfolio\Unreal\Project\UE_PUBG\Source\UE_PUBG\Character\Component\C_InvenComponent.cpp", "C++", 332, 0, 106, 91, 529
"c:\Users\wadan\Desktop\SGA\Portfolio\Unreal\Project\UE_PUBG\Source\UE_PUBG\Character\Component\C_InvenComponent.h", "C++", 115, 0, 54, 64, 233
"c:\Users\wadan\Desktop\SGA\Portfolio\Unreal\Project\UE_PUBG\Source\UE_PUBG\Character\Component\C_InvenSystem.cpp", "C++", 91, 0, 24, 42, 157
"c:\Users\wadan\Desktop\SGA\Portfolio\Unreal\Project\UE_PUBG\Source\UE_PUBG\Character\Component\C_InvenSystem.h", "C++", 38, 0, 20, 21, 79
"c:\Users\wadan\Desktop\SGA\Portfolio\Unreal\Project\UE_PUBG\Source\UE_PUBG\Character\Component\C_ParkourComponent.cpp", "C++", 492, 0, 91, 158, 741
"c:\Users\wadan\Desktop\SGA\Portfolio\Unreal\Project\UE_PUBG\Source\UE_PUBG\Character\Component\C_ParkourComponent.h", "C++", 105, 0, 77, 71, 253
"c:\Users\wadan\Desktop\SGA\Portfolio\Unreal\Project\UE_PUBG\Source\UE_PUBG\Character\Component\C_PingSystemComponent.cpp", "C++", 48, 0, 3, 23, 74
"c:\Users\wadan\Desktop\SGA\Portfolio\Unreal\Project\UE_PUBG\Source\UE_PUBG\Character\Component\C_PingSystemComponent.h", "C++", 28, 0, 10, 25, 63
"c:\Users\wadan\Desktop\SGA\Portfolio\Unreal\Project\UE_PUBG\Source\UE_PUBG\Character\Component\C_PlayerController.cpp", "C++", 14, 0, 1, 4, 19
"c:\Users\wadan\Desktop\SGA\Portfolio\Unreal\Project\UE_PUBG\Source\UE_PUBG\Character\Component\C_PlayerController.h", "C++", 11, 0, 4, 5, 20
"c:\Users\wadan\Desktop\SGA\Portfolio\Unreal\Project\UE_PUBG\Source\UE_PUBG\Character\Component\C_PoseColliderHandlerComponent.cpp", "C++", 227, 0, 48, 89, 364
"c:\Users\wadan\Desktop\SGA\Portfolio\Unreal\Project\UE_PUBG\Source\UE_PUBG\Character\Component\C_PoseColliderHandlerComponent.h", "C++", 70, 0, 67, 50, 187
"c:\Users\wadan\Desktop\SGA\Portfolio\Unreal\Project\UE_PUBG\Source\UE_PUBG\Character\Component\C_SkyDivingComponent.cpp", "C++", 274, 0, 54, 92, 420
"c:\Users\wadan\Desktop\SGA\Portfolio\Unreal\Project\UE_PUBG\Source\UE_PUBG\Character\Component\C_SkyDivingComponent.h", "C++", 109, 0, 40, 58, 207
"c:\Users\wadan\Desktop\SGA\Portfolio\Unreal\Project\UE_PUBG\Source\UE_PUBG\Character\Component\C_StatComponent.cpp", "C++", 118, 0, 11, 48, 177
"c:\Users\wadan\Desktop\SGA\Portfolio\Unreal\Project\UE_PUBG\Source\UE_PUBG\Character\Component\C_StatComponent.h", "C++", 108, 0, 38, 54, 200
"c:\Users\wadan\Desktop\SGA\Portfolio\Unreal\Project\UE_PUBG\Source\UE_PUBG\Character\Component\C_SwimmingComponent.cpp", "C++", 245, 0, 42, 88, 375
"c:\Users\wadan\Desktop\SGA\Portfolio\Unreal\Project\UE_PUBG\Source\UE_PUBG\Character\Component\C_SwimmingComponent.h", "C++", 72, 0, 24, 40, 136
"c:\Users\wadan\Desktop\SGA\Portfolio\Unreal\Project\UE_PUBG\Source\UE_PUBG\Character\Component\ParkourActionStrategy\C_MantleHighActionStrategy.cpp", "C++", 41, 0, 5, 27, 73
"c:\Users\wadan\Desktop\SGA\Portfolio\Unreal\Project\UE_PUBG\Source\UE_PUBG\Character\Component\ParkourActionStrategy\C_MantleHighActionStrategy.h", "C++", 12, 0, 4, 7, 23
"c:\Users\wadan\Desktop\SGA\Portfolio\Unreal\Project\UE_PUBG\Source\UE_PUBG\Character\Component\ParkourActionStrategy\C_MantleLowActionStrategy.cpp", "C++", 26, 0, 3, 18, 47
"c:\Users\wadan\Desktop\SGA\Portfolio\Unreal\Project\UE_PUBG\Source\UE_PUBG\Character\Component\ParkourActionStrategy\C_MantleLowActionStrategy.h", "C++", 12, 0, 4, 7, 23
"c:\Users\wadan\Desktop\SGA\Portfolio\Unreal\Project\UE_PUBG\Source\UE_PUBG\Character\Component\ParkourActionStrategy\C_VaultHighActionStrategy.cpp", "C++", 43, 0, 6, 28, 77
"c:\Users\wadan\Desktop\SGA\Portfolio\Unreal\Project\UE_PUBG\Source\UE_PUBG\Character\Component\ParkourActionStrategy\C_VaultHighActionStrategy.h", "C++", 12, 0, 4, 6, 22
"c:\Users\wadan\Desktop\SGA\Portfolio\Unreal\Project\UE_PUBG\Source\UE_PUBG\Character\Component\ParkourActionStrategy\C_VaultLowActionStrategy.cpp", "C++", 45, 0, 7, 26, 78
"c:\Users\wadan\Desktop\SGA\Portfolio\Unreal\Project\UE_PUBG\Source\UE_PUBG\Character\Component\ParkourActionStrategy\C_VaultLowActionStrategy.h", "C++", 12, 0, 4, 7, 23
"c:\Users\wadan\Desktop\SGA\Portfolio\Unreal\Project\UE_PUBG\Source\UE_PUBG\Character\Component\ParkourActionStrategy\I_ParkourActionStrategy.cpp", "C++", 1, 0, 2, 4, 7
"c:\Users\wadan\Desktop\SGA\Portfolio\Unreal\Project\UE_PUBG\Source\UE_PUBG\Character\Component\ParkourActionStrategy\I_ParkourActionStrategy.h", "C++", 15, 0, 10, 9, 34
"c:\Users\wadan\Desktop\SGA\Portfolio\Unreal\Project\UE_PUBG\Source\UE_PUBG\HUD\C_HUDWidget.cpp", "C++", 8, 0, 1, 6, 15
"c:\Users\wadan\Desktop\SGA\Portfolio\Unreal\Project\UE_PUBG\Source\UE_PUBG\HUD\C_HUDWidget.h", "C++", 68, 0, 34, 41, 143
"c:\Users\wadan\Desktop\SGA\Portfolio\Unreal\Project\UE_PUBG\Source\UE_PUBG\HUD\C_InstructionWidget.cpp", "C++", 1, 0, 1, 4, 6
"c:\Users\wadan\Desktop\SGA\Portfolio\Unreal\Project\UE_PUBG\Source\UE_PUBG\HUD\C_InstructionWidget.h", "C++", 14, 0, 4, 8, 26
"c:\Users\wadan\Desktop\SGA\Portfolio\Unreal\Project\UE_PUBG\Source\UE_PUBG\HUD\C_MainMapWidget.cpp", "C++", 278, 0, 58, 105, 441
"c:\Users\wadan\Desktop\SGA\Portfolio\Unreal\Project\UE_PUBG\Source\UE_PUBG\HUD\C_MainMapWidget.h", "C++", 60, 0, 43, 45, 148
"c:\Users\wadan\Desktop\SGA\Portfolio\Unreal\Project\UE_PUBG\Source\UE_PUBG\HUD\C_MapWidget.cpp", "C++", 103, 0, 20, 40, 163
"c:\Users\wadan\Desktop\SGA\Portfolio\Unreal\Project\UE_PUBG\Source\UE_PUBG\HUD\C_MapWidget.h", "C++", 64, 0, 63, 50, 177
"c:\Users\wadan\Desktop\SGA\Portfolio\Unreal\Project\UE_PUBG\Source\UE_PUBG\HUD\C_OxygenWidget.cpp", "C++", 1, 0, 1, 4, 6
"c:\Users\wadan\Desktop\SGA\Portfolio\Unreal\Project\UE_PUBG\Source\UE_PUBG\HUD\C_OxygenWidget.h", "C++", 12, 0, 7, 8, 27
"c:\Users\wadan\Desktop\SGA\Portfolio\Unreal\Project\UE_PUBG\Source\UE_PUBG\HUD\C_SkyDiveWidget.cpp", "C++", 73, 0, 10, 32, 115
"c:\Users\wadan\Desktop\SGA\Portfolio\Unreal\Project\UE_PUBG\Source\UE_PUBG\HUD\C_SkyDiveWidget.h", "C++", 48, 0, 12, 31, 91
"c:\Users\wadan\Desktop\SGA\Portfolio\Unreal\Project\UE_PUBG\Source\UE_PUBG\InvenUserInterface\C_BasicSlotWidget.cpp", "C++", 57, 0, 14, 30, 101
"c:\Users\wadan\Desktop\SGA\Portfolio\Unreal\Project\UE_PUBG\Source\UE_PUBG\InvenUserInterface\C_BasicSlotWidget.h", "C++", 23, 0, 5, 12, 40
"c:\Users\wadan\Desktop\SGA\Portfolio\Unreal\Project\UE_PUBG\Source\UE_PUBG\InvenUserInterface\C_BasicUserWidget.cpp", "C++", 1, 0, 1, 4, 6
"c:\Users\wadan\Desktop\SGA\Portfolio\Unreal\Project\UE_PUBG\Source\UE_PUBG\InvenUserInterface\C_BasicUserWidget.h", "C++", 9, 0, 4, 5, 18
"c:\Users\wadan\Desktop\SGA\Portfolio\Unreal\Project\UE_PUBG\Source\UE_PUBG\InvenUserInterface\C_CustomListView.cpp", "C++", 11, 0, 9, 7, 27
"c:\Users\wadan\Desktop\SGA\Portfolio\Unreal\Project\UE_PUBG\Source\UE_PUBG\InvenUserInterface\C_CustomListView.h", "C++", 19, 0, 5, 10, 34
"c:\Users\wadan\Desktop\SGA\Portfolio\Unreal\Project\UE_PUBG\Source\UE_PUBG\InvenUserInterface\C_DragDropOperation.cpp", "C++", 1, 0, 1, 4, 6
"c:\Users\wadan\Desktop\SGA\Portfolio\Unreal\Project\UE_PUBG\Source\UE_PUBG\InvenUserInterface\C_DragDropOperation.h", "C++", 21, 0, 4, 9, 34
"c:\Users\wadan\Desktop\SGA\Portfolio\Unreal\Project\UE_PUBG\Source\UE_PUBG\InvenUserInterface\C_EquipSlot.cpp", "C++", 68, 0, 12, 13, 93
"c:\Users\wadan\Desktop\SGA\Portfolio\Unreal\Project\UE_PUBG\Source\UE_PUBG\InvenUserInterface\C_EquipSlot.h", "C++", 21, 0, 16, 13, 50
"c:\Users\wadan\Desktop\SGA\Portfolio\Unreal\Project\UE_PUBG\Source\UE_PUBG\InvenUserInterface\C_EquipmentPanel.cpp", "C++", 40, 0, 1, 10, 51
"c:\Users\wadan\Desktop\SGA\Portfolio\Unreal\Project\UE_PUBG\Source\UE_PUBG\InvenUserInterface\C_EquipmentPanel.h", "C++", 37, 0, 4, 18, 59
"c:\Users\wadan\Desktop\SGA\Portfolio\Unreal\Project\UE_PUBG\Source\UE_PUBG\InvenUserInterface\C_InvenUiWidget.cpp", "C++", 140, 0, 75, 64, 279
"c:\Users\wadan\Desktop\SGA\Portfolio\Unreal\Project\UE_PUBG\Source\UE_PUBG\InvenUserInterface\C_InvenUiWidget.h", "C++", 60, 0, 13, 36, 109
"c:\Users\wadan\Desktop\SGA\Portfolio\Unreal\Project\UE_PUBG\Source\UE_PUBG\InvenUserInterface\C_ItemBarWidget.cpp", "C++", 157, 0, 59, 67, 283
"c:\Users\wadan\Desktop\SGA\Portfolio\Unreal\Project\UE_PUBG\Source\UE_PUBG\InvenUserInterface\C_ItemBarWidget.h", "C++", 49, 0, 17, 26, 92
"c:\Users\wadan\Desktop\SGA\Portfolio\Unreal\Project\UE_PUBG\Source\UE_PUBG\InvenUserInterface\C_MainGunWidget.cpp", "C++", 112, 0, 17, 39, 168
"c:\Users\wadan\Desktop\SGA\Portfolio\Unreal\Project\UE_PUBG\Source\UE_PUBG\InvenUserInterface\C_MainGunWidget.h", "C++", 31, 0, 12, 19, 62
"c:\Users\wadan\Desktop\SGA\Portfolio\Unreal\Project\UE_PUBG\Source\UE_PUBG\InvenUserInterface\C_MyItemListWidget.cpp", "C++", 82, 0, 6, 20, 108
"c:\Users\wadan\Desktop\SGA\Portfolio\Unreal\Project\UE_PUBG\Source\UE_PUBG\InvenUserInterface\C_MyItemListWidget.h", "C++", 25, 0, 14, 14, 53
"c:\Users\wadan\Desktop\SGA\Portfolio\Unreal\Project\UE_PUBG\Source\UE_PUBG\InvenUserInterface\C_ThrowableWidget.cpp", "C++", 101, 0, 4, 17, 122
"c:\Users\wadan\Desktop\SGA\Portfolio\Unreal\Project\UE_PUBG\Source\UE_PUBG\InvenUserInterface\C_ThrowableWidget.h", "C++", 32, 0, 10, 20, 62
"c:\Users\wadan\Desktop\SGA\Portfolio\Unreal\Project\UE_PUBG\Source\UE_PUBG\Item\AttachmentActors\AttachmentActor.cpp", "C++", 13, 0, 5, 10, 28
"c:\Users\wadan\Desktop\SGA\Portfolio\Unreal\Project\UE_PUBG\Source\UE_PUBG\Item\AttachmentActors\AttachmentActor.h", "C++", 32, 0, 4, 7, 43
"c:\Users\wadan\Desktop\SGA\Portfolio\Unreal\Project\UE_PUBG\Source\UE_PUBG\Item\AttachmentActors\C_Attachment_Compensator.cpp", "C++", 46, 0, 1, 10, 57
"c:\Users\wadan\Desktop\SGA\Portfolio\Unreal\Project\UE_PUBG\Source\UE_PUBG\Item\AttachmentActors\C_Attachment_Compensator.h", "C++", 18, 0, 7, 7, 32
"c:\Users\wadan\Desktop\SGA\Portfolio\Unreal\Project\UE_PUBG\Source\UE_PUBG\Item\AttachmentActors\C_Attachment_RedDot.cpp", "C++", 42, 0, 1, 13, 56
"c:\Users\wadan\Desktop\SGA\Portfolio\Unreal\Project\UE_PUBG\Source\UE_PUBG\Item\AttachmentActors\C_Attachment_RedDot.h", "C++", 17, 0, 7, 6, 30
"c:\Users\wadan\Desktop\SGA\Portfolio\Unreal\Project\UE_PUBG\Source\UE_PUBG\Item\AttachmentActors\C_Attachment_Scope4X.cpp", "C++", 61, 0, 2, 11, 74
"c:\Users\wadan\Desktop\SGA\Portfolio\Unreal\Project\UE_PUBG\Source\UE_PUBG\Item\AttachmentActors\C_Attachment_Scope4X.h", "C++", 19, 0, 7, 7, 33
"c:\Users\wadan\Desktop\SGA\Portfolio\Unreal\Project\UE_PUBG\Source\UE_PUBG\Item\AttachmentActors\C_Attachment_VertGrip.cpp", "C++", 47, 0, 1, 12, 60
"c:\Users\wadan\Desktop\SGA\Portfolio\Unreal\Project\UE_PUBG\Source\UE_PUBG\Item\AttachmentActors\C_Attachment_VertGrip.h", "C++", 18, 0, 7, 7, 32
"c:\Users\wadan\Desktop\SGA\Portfolio\Unreal\Project\UE_PUBG\Source\UE_PUBG\Item\Attachment\C_AttachableItem.cpp", "C++", 63, 0, 4, 15, 82
"c:\Users\wadan\Desktop\SGA\Portfolio\Unreal\Project\UE_PUBG\Source\UE_PUBG\Item\Attachment\C_AttachableItem.h", "C++", 19, 0, 4, 10, 33
"c:\Users\wadan\Desktop\SGA\Portfolio\Unreal\Project\UE_PUBG\Source\UE_PUBG\Item\C_Item.cpp", "C++", 65, 0, 25, 26, 116
"c:\Users\wadan\Desktop\SGA\Portfolio\Unreal\Project\UE_PUBG\Source\UE_PUBG\Item\C_Item.h", "C++", 142, 0, 74, 59, 275
"c:\Users\wadan\Desktop\SGA\Portfolio\Unreal\Project\UE_PUBG\Source\UE_PUBG\Item\ConsumableItem\Boosting\C_EnergyDrink.cpp", "C++", 37, 0, 1, 14, 52
"c:\Users\wadan\Desktop\SGA\Portfolio\Unreal\Project\UE_PUBG\Source\UE_PUBG\Item\ConsumableItem\Boosting\C_EnergyDrink.h", "C++", 19, 0, 7, 11, 37
"c:\Users\wadan\Desktop\SGA\Portfolio\Unreal\Project\UE_PUBG\Source\UE_PUBG\Item\ConsumableItem\Boosting\C_PainKiller.cpp", "C++", 37, 0, 1, 14, 52
"c:\Users\wadan\Desktop\SGA\Portfolio\Unreal\Project\UE_PUBG\Source\UE_PUBG\Item\ConsumableItem\Boosting\C_PainKiller.h", "C++", 19, 0, 7, 11, 37
"c:\Users\wadan\Desktop\SGA\Portfolio\Unreal\Project\UE_PUBG\Source\UE_PUBG\Item\ConsumableItem\C_BoostItem.cpp", "C++", 38, 0, 1, 13, 52
"c:\Users\wadan\Desktop\SGA\Portfolio\Unreal\Project\UE_PUBG\Source\UE_PUBG\Item\ConsumableItem\C_BoostItem.h", "C++", 22, 0, 4, 16, 42
"c:\Users\wadan\Desktop\SGA\Portfolio\Unreal\Project\UE_PUBG\Source\UE_PUBG\Item\ConsumableItem\C_ConsumableItem.cpp", "C++", 201, 0, 34, 71, 306
"c:\Users\wadan\Desktop\SGA\Portfolio\Unreal\Project\UE_PUBG\Source\UE_PUBG\Item\ConsumableItem\C_ConsumableItem.h", "C++", 57, 0, 36, 46, 139
"c:\Users\wadan\Desktop\SGA\Portfolio\Unreal\Project\UE_PUBG\Source\UE_PUBG\Item\ConsumableItem\C_HealItem.cpp", "C++", 42, 0, 2, 13, 57
"c:\Users\wadan\Desktop\SGA\Portfolio\Unreal\Project\UE_PUBG\Source\UE_PUBG\Item\ConsumableItem\C_HealItem.h", "C++", 24, 0, 5, 16, 45
"c:\Users\wadan\Desktop\SGA\Portfolio\Unreal\Project\UE_PUBG\Source\UE_PUBG\Item\ConsumableItem\Healing\C_Bandage.cpp", "C++", 63, 0, 3, 19, 85
"c:\Users\wadan\Desktop\SGA\Portfolio\Unreal\Project\UE_PUBG\Source\UE_PUBG\Item\ConsumableItem\Healing\C_Bandage.h", "C++", 28, 0, 8, 18, 54
"c:\Users\wadan\Desktop\SGA\Portfolio\Unreal\Project\UE_PUBG\Source\UE_PUBG\Item\ConsumableItem\Healing\C_FirstAidKit.cpp", "C++", 52, 0, 2, 20, 74
"c:\Users\wadan\Desktop\SGA\Portfolio\Unreal\Project\UE_PUBG\Source\UE_PUBG\Item\ConsumableItem\Healing\C_FirstAidKit.h", "C++", 21, 0, 7, 12, 40
"c:\Users\wadan\Desktop\SGA\Portfolio\Unreal\Project\UE_PUBG\Source\UE_PUBG\Item\ConsumableItem\Healing\C_MedKit.cpp", "C++", 68, 0, 6, 23, 97
"c:\Users\wadan\Desktop\SGA\Portfolio\Unreal\Project\UE_PUBG\Source\UE_PUBG\Item\ConsumableItem\Healing\C_MedKit.h", "C++", 28, 0, 7, 16, 51
"c:\Users\wadan\Desktop\SGA\Portfolio\Unreal\Project\UE_PUBG\Source\UE_PUBG\Item\Equipment\C_BackPack.cpp", "C++", 118, 0, 24, 53, 195
"c:\Users\wadan\Desktop\SGA\Portfolio\Unreal\Project\UE_PUBG\Source\UE_PUBG\Item\Equipment\C_BackPack.h", "C++", 28, 0, 18, 23, 69
"c:\Users\wadan\Desktop\SGA\Portfolio\Unreal\Project\UE_PUBG\Source\UE_PUBG\Item\Equipment\C_EquipableItem.cpp", "C++", 44, 0, 6, 14, 64
"c:\Users\wadan\Desktop\SGA\Portfolio\Unreal\Project\UE_PUBG\Source\UE_PUBG\Item\Equipment\C_EquipableItem.h", "C++", 32, 0, 10, 19, 61
"c:\Users\wadan\Desktop\SGA\Portfolio\Unreal\Project\UE_PUBG\Source\UE_PUBG\Item\Equipment\C_Helmet.cpp", "C++", 1, 0, 1, 4, 6
"c:\Users\wadan\Desktop\SGA\Portfolio\Unreal\Project\UE_PUBG\Source\UE_PUBG\Item\Equipment\C_Helmet.h", "C++", 11, 0, 4, 6, 21
"c:\Users\wadan\Desktop\SGA\Portfolio\Unreal\Project\UE_PUBG\Source\UE_PUBG\Item\Equipment\C_Vest.cpp", "C++", 48, 0, 7, 16, 71
"c:\Users\wadan\Desktop\SGA\Portfolio\Unreal\Project\UE_PUBG\Source\UE_PUBG\Item\Equipment\C_Vest.h", "C++", 17, 0, 4, 10, 31
"c:\Users\wadan\Desktop\SGA\Portfolio\Unreal\Project\UE_PUBG\Source\UE_PUBG\Item\Weapon\C_Weapon.cpp", "C++", 108, 0, 5, 26, 139
"c:\Users\wadan\Desktop\SGA\Portfolio\Unreal\Project\UE_PUBG\Source\UE_PUBG\Item\Weapon\C_Weapon.h", "C++", 49, 0, 53, 39, 141
"c:\Users\wadan\Desktop\SGA\Portfolio\Unreal\Project\UE_PUBG\Source\UE_PUBG\Item\Weapon\Gun\C_AR.cpp", "C++", 35, 0, 2, 10, 47
"c:\Users\wadan\Desktop\SGA\Portfolio\Unreal\Project\UE_PUBG\Source\UE_PUBG\Item\Weapon\Gun\C_AR.h", "C++", 16, 0, 6, 7, 29
"c:\Users\wadan\Desktop\SGA\Portfolio\Unreal\Project\UE_PUBG\Source\UE_PUBG\Item\Weapon\Gun\C_Bullet.cpp", "C++", 169, 0, 34, 60, 263
"c:\Users\wadan\Desktop\SGA\Portfolio\Unreal\Project\UE_PUBG\Source\UE_PUBG\Item\Weapon\Gun\C_Bullet.h", "C++", 54, 0, 11, 19, 84
"c:\Users\wadan\Desktop\SGA\Portfolio\Unreal\Project\UE_PUBG\Source\UE_PUBG\Item\Weapon\Gun\C_Gun.cpp", "C++", 682, 0, 122, 144, 948
"c:\Users\wadan\Desktop\SGA\Portfolio\Unreal\Project\UE_PUBG\Source\UE_PUBG\Item\Weapon\Gun\C_Gun.h", "C++", 201, 0, 21, 59, 281
"c:\Users\wadan\Desktop\SGA\Portfolio\Unreal\Project\UE_PUBG\Source\UE_PUBG\Item\Weapon\Gun\C_SR.cpp", "C++", 84, 0, 6, 13, 103
"c:\Users\wadan\Desktop\SGA\Portfolio\Unreal\Project\UE_PUBG\Source\UE_PUBG\Item\Weapon\Gun\C_SR.h", "C++", 26, 0, 6, 6, 38
"c:\Users\wadan\Desktop\SGA\Portfolio\Unreal\Project\UE_PUBG\Source\UE_PUBG\Item\Weapon\MeleeWeapon\C_MeleeWeapon.cpp", "C++", 149, 0, 41, 46, 236
"c:\Users\wadan\Desktop\SGA\Portfolio\Unreal\Project\UE_PUBG\Source\UE_PUBG\Item\Weapon\MeleeWeapon\C_MeleeWeapon.h", "C++", 55, 0, 34, 36, 125
"c:\Users\wadan\Desktop\SGA\Portfolio\Unreal\Project\UE_PUBG\Source\UE_PUBG\Item\Weapon\ThrowingWeapon\C_FlashBangExplode.cpp", "C++", 97, 0, 22, 48, 167
"c:\Users\wadan\Desktop\SGA\Portfolio\Unreal\Project\UE_PUBG\Source\UE_PUBG\Item\Weapon\ThrowingWeapon\C_FlashBangExplode.h", "C++", 21, 0, 21, 21, 63
"c:\Users\wadan\Desktop\SGA\Portfolio\Unreal\Project\UE_PUBG\Source\UE_PUBG\Item\Weapon\ThrowingWeapon\C_GrenadeExplode.cpp", "C++", 159, 0, 71, 73, 303
"c:\Users\wadan\Desktop\SGA\Portfolio\Unreal\Project\UE_PUBG\Source\UE_PUBG\Item\Weapon\ThrowingWeapon\C_GrenadeExplode.h", "C++", 24, 0, 29, 21, 74
"c:\Users\wadan\Desktop\SGA\Portfolio\Unreal\Project\UE_PUBG\Source\UE_PUBG\Item\Weapon\ThrowingWeapon\C_ScreenShotWidget.cpp", "C++", 17, 0, 13, 12, 42
"c:\Users\wadan\Desktop\SGA\Portfolio\Unreal\Project\UE_PUBG\Source\UE_PUBG\Item\Weapon\ThrowingWeapon\C_ScreenShotWidget.h", "C++", 17, 0, 4, 12, 33
"c:\Users\wadan\Desktop\SGA\Portfolio\Unreal\Project\UE_PUBG\Source\UE_PUBG\Item\Weapon\ThrowingWeapon\C_SmokeGrndExplode.cpp", "C++", 15, 0, 1, 8, 24
"c:\Users\wadan\Desktop\SGA\Portfolio\Unreal\Project\UE_PUBG\Source\UE_PUBG\Item\Weapon\ThrowingWeapon\C_SmokeGrndExplode.h", "C++", 12, 0, 1, 8, 21
"c:\Users\wadan\Desktop\SGA\Portfolio\Unreal\Project\UE_PUBG\Source\UE_PUBG\Item\Weapon\ThrowingWeapon\C_ThrowingWeapon.cpp", "C++", 643, 0, 155, 229, 1027
"c:\Users\wadan\Desktop\SGA\Portfolio\Unreal\Project\UE_PUBG\Source\UE_PUBG\Item\Weapon\ThrowingWeapon\C_ThrowingWeapon.h", "C++", 158, 0, 70, 101, 329
"c:\Users\wadan\Desktop\SGA\Portfolio\Unreal\Project\UE_PUBG\Source\UE_PUBG\Item\Weapon\ThrowingWeapon\I_ExplodeStrategy.cpp", "C++", 1, 0, 2, 4, 7
"c:\Users\wadan\Desktop\SGA\Portfolio\Unreal\Project\UE_PUBG\Source\UE_PUBG\Item\Weapon\ThrowingWeapon\I_ExplodeStrategy.h", "C++", 15, 0, 10, 7, 32
"c:\Users\wadan\Desktop\SGA\Portfolio\Unreal\Project\UE_PUBG\Source\UE_PUBG\Item\Weapon\WeaponStrategy\C_GunStrategy.cpp", "C++", 164, 0, 12, 47, 223
"c:\Users\wadan\Desktop\SGA\Portfolio\Unreal\Project\UE_PUBG\Source\UE_PUBG\Item\Weapon\WeaponStrategy\C_GunStrategy.h", "C++", 24, 0, 4, 11, 39
"c:\Users\wadan\Desktop\SGA\Portfolio\Unreal\Project\UE_PUBG\Source\UE_PUBG\Item\Weapon\WeaponStrategy\C_MeleeWeaponStrategy.cpp", "C++", 50, 0, 1, 24, 75
"c:\Users\wadan\Desktop\SGA\Portfolio\Unreal\Project\UE_PUBG\Source\UE_PUBG\Item\Weapon\WeaponStrategy\C_MeleeWeaponStrategy.h", "C++", 19, 0, 4, 11, 34
"c:\Users\wadan\Desktop\SGA\Portfolio\Unreal\Project\UE_PUBG\Source\UE_PUBG\Item\Weapon\WeaponStrategy\C_ThrowingWeaponStrategy.cpp", "C++", 56, 0, 2, 24, 82
"c:\Users\wadan\Desktop\SGA\Portfolio\Unreal\Project\UE_PUBG\Source\UE_PUBG\Item\Weapon\WeaponStrategy\C_ThrowingWeaponStrategy.h", "C++", 19, 0, 5, 11, 35
"c:\Users\wadan\Desktop\SGA\Portfolio\Unreal\Project\UE_PUBG\Source\UE_PUBG\Item\Weapon\WeaponStrategy\I_WeaponButtonStrategy.cpp", "C++", 1, 0, 2, 4, 7
"c:\Users\wadan\Desktop\SGA\Portfolio\Unreal\Project\UE_PUBG\Source\UE_PUBG\Item\Weapon\WeaponStrategy\I_WeaponButtonStrategy.h", "C++", 22, 0, 54, 17, 93
"c:\Users\wadan\Desktop\SGA\Portfolio\Unreal\Project\UE_PUBG\Source\UE_PUBG\MagneticField\C_MagneticFieldManager.cpp", "C++", 142, 0, 21, 64, 227
"c:\Users\wadan\Desktop\SGA\Portfolio\Unreal\Project\UE_PUBG\Source\UE_PUBG\MagneticField\C_MagneticFieldManager.h", "C++", 84, 0, 39, 46, 169
"c:\Users\wadan\Desktop\SGA\Portfolio\Unreal\Project\UE_PUBG\Source\UE_PUBG\MagneticField\C_MagneticWall.cpp", "C++", 26, 0, 6, 13, 45
"c:\Users\wadan\Desktop\SGA\Portfolio\Unreal\Project\UE_PUBG\Source\UE_PUBG\MagneticField\C_MagneticWall.h", "C++", 19, 0, 4, 12, 35
"c:\Users\wadan\Desktop\SGA\Portfolio\Unreal\Project\UE_PUBG\Source\UE_PUBG\MyWaterBody.cpp", "C++", 1, 0, 1, 4, 6
"c:\Users\wadan\Desktop\SGA\Portfolio\Unreal\Project\UE_PUBG\Source\UE_PUBG\MyWaterBody.h", "C++", 9, 0, 4, 5, 18
"c:\Users\wadan\Desktop\SGA\Portfolio\Unreal\Project\UE_PUBG\Source\UE_PUBG\Singleton\C_GameSceneManager.cpp", "C++", 22, 0, 3, 9, 34
"c:\Users\wadan\Desktop\SGA\Portfolio\Unreal\Project\UE_PUBG\Source\UE_PUBG\Singleton\C_GameSceneManager.h", "C++", 23, 0, 8, 17, 48
"c:\Users\wadan\Desktop\SGA\Portfolio\Unreal\Project\UE_PUBG\Source\UE_PUBG\UE_PUBG.Build.cs", "C#", 0, 25, 17, 9, 51
"c:\Users\wadan\Desktop\SGA\Portfolio\Unreal\Project\UE_PUBG\Source\UE_PUBG\UE_PUBG.cpp", "C++", 3, 0, 1, 3, 7
"c:\Users\wadan\Desktop\SGA\Portfolio\Unreal\Project\UE_PUBG\Source\UE_PUBG\UE_PUBG.h", "C++", 2, 0, 1, 3, 6
"c:\Users\wadan\Desktop\SGA\Portfolio\Unreal\Project\UE_PUBG\Source\UE_PUBG\UE_PUBGCharacter.cpp", "C++", 79, 0, 27, 24, 130
"c:\Users\wadan\Desktop\SGA\Portfolio\Unreal\Project\UE_PUBG\Source\UE_PUBG\UE_PUBGCharacter.h", "C++", 39, 0, 13, 22, 74
"c:\Users\wadan\Desktop\SGA\Portfolio\Unreal\Project\UE_PUBG\Source\UE_PUBG\UE_PUBGGameMode.cpp", "C++", 14, 0, 6, 6, 26
"c:\Users\wadan\Desktop\SGA\Portfolio\Unreal\Project\UE_PUBG\Source\UE_PUBG\UE_PUBGGameMode.h", "C++", 11, 0, 1, 8, 20
"c:\Users\wadan\Desktop\SGA\Portfolio\Unreal\Project\UE_PUBG\Source\UE_PUBG\Utility\C_TimelineComponent.cpp", "C++", 0, 0, 0, 1, 1
"c:\Users\wadan\Desktop\SGA\Portfolio\Unreal\Project\UE_PUBG\Source\UE_PUBG\Utility\C_TimelineUtility.cpp", "C++", 109, 0, 16, 25, 150
"c:\Users\wadan\Desktop\SGA\Portfolio\Unreal\Project\UE_PUBG\Source\UE_PUBG\Utility\C_TimelineUtility.h", "C++", 59, 0, 9, 20, 88
"c:\Users\wadan\Desktop\SGA\Portfolio\Unreal\Project\UE_PUBG\Source\UE_PUBG\Utility\C_Util.cpp", "C++", 43, 0, 1, 12, 56
"c:\Users\wadan\Desktop\SGA\Portfolio\Unreal\Project\UE_PUBG\Source\UE_PUBG\Utility\C_Util.h", "C++", 20, 0, 4, 7, 31
"Total", "-", 13757, 25, 3651, 5533, 22966